"lang"
{
"Language"	"schinese"
"Tokens"
{
"D2L_Game_VerifyGameFiles$appType=game"	"验证Dota 2文件的完整性..."
"[english]D2L_Game_VerifyGameFiles$appType=game"	"Verify integrity of Dota 2 files..."
"D2L_Game_SetLaunchOptions"	"设置启动选项..."
"[english]D2L_Game_SetLaunchOptions"	"Set launch options..."
"D2L_VerifyContactEmaill"	"验证电子邮件地址..."
"[english]D2L_VerifyContactEmaill"	"Verify email address..."
"D2L_LockAccountButton"	"启用Dota 2令牌来保护我的账号(推荐)"
"[english]D2L_LockAccountButton"	"Protect my account with Dota 2 Guard (Recommended)"
"D2L_ManageSecurityButton"	"管理Dota 2令牌账号安全设定..."
"[english]D2L_ManageSecurityButton"	"Manage Dota 2 Guard Account Security..."
"D2L_ChangeContactEmail"	"更改联系电子邮件地址..."
"[english]D2L_ChangeContactEmail"	"Change contact email address..."
"D2L_ChangePassword"	"更改密码或安全提问..."
"[english]D2L_ChangePassword"	"Change password or secret question..."
"D2L_PickShortcutApp"	"更改..."
"[english]D2L_PickShortcutApp"	"Change..."
"D2L_ChangeUser"	"作为另一个用户登录..."
"[english]D2L_ChangeUser"	"Login as a different user..."
"D2L_Settings_Security_Status_Label"	"安全状态："
"[english]D2L_Settings_Security_Status_Label"	"Security Status:"
"D2L_Settings_Security_Status_State_0"	"电子邮件地址尚未验证"
"[english]D2L_Settings_Security_Status_State_0"	"Email address not yet verified"
"D2L_Settings_Security_Status_State_1"	"Dota 2令牌保护中"
"[english]D2L_Settings_Security_Status_State_1"	"Protected by Dota 2 Guard"
"D2L_Settings_Security_Status_State_1_WithTime"	"自 %s1 起使用Dota 2令牌进行保护"
"[english]D2L_Settings_Security_Status_State_1_WithTime"	"Protected by Dota 2 Guard since %s1"
"D2L_Settings_Security_Status_State_2"	"Dota 2令牌已关闭"
"[english]D2L_Settings_Security_Status_State_2"	"Dota 2 Guard disabled"
"D2L_Settings_Security_Status_State_3"	"离线或未知状态"
"[english]D2L_Settings_Security_Status_State_3"	"Unknown, offline"
"D2L_Settings_Security_Status_State_4"	"Dota 2令牌未启用"
"[english]D2L_Settings_Security_Status_State_4"	"Dota 2 Guard not enabled"
"D2L_EmailAddressUnverified"	"未指定"
"[english]D2L_EmailAddressUnverified"	"Not specified"
"D2L_LogoutDialogLabel"	"帐号名称："
"[english]D2L_LogoutDialogLabel"	"Account Name:"
"D2L_ChangeContactEmailLabel"	"联系电子邮件："
"[english]D2L_ChangeContactEmailLabel"	"Contact Email:"
"D2L_AccountPage_BetaParticipation"	"参与测试："
"[english]D2L_AccountPage_BetaParticipation"	"Beta participation:"
"D2L_NoBetaAvailable"	"（目前均不可用）"
"[english]D2L_NoBetaAvailable"	"(None currently available)"
"D2L_InternetSpeedDescription"	"您的互联网连接的大概速度"
"[english]D2L_InternetSpeedDescription"	"Approximate speed of your Internet connection"
"D2L_RegionLabel"	"下载区"
"[english]D2L_RegionLabel"	"Download region"
"D2L_EnableCloud"	"启用Dota 2云同步来统一配置文件和英雄攻略"
"[english]D2L_EnableCloud"	"Enable Dota 2 Cloud synchronization for config files and hero builds"
"D2L_LaunchDota2"	"运行Dota 2"
"[english]D2L_LaunchDota2"	"Launch Dota 2"
"D2L_Welcome"	"本周更新"
"[english]D2L_Welcome"	"New This Week"
"D2L_Settings"	"设置"
"[english]D2L_Settings"	"Settings"
"D2L_Download"	"下载"
"[english]D2L_Download"	"Download"
"D2L_Support"	"客服支持"
"[english]D2L_Support"	"Support"
"D2L_VerifyEmail_Verified"	"已验证"
"[english]D2L_VerifyEmail_Verified"	"Verified"
"D2L_VerifyEmail_Unverified"	"未验证"
"[english]D2L_VerifyEmail_Unverified"	"Unverified"
"D2L_Modem_56k"	"调制解调器 - 56kbps"
"[english]D2L_Modem_56k"	"Modem - 56kbps"
"D2L_DSL_256k"	"DSL，速度高于256kbps"
"[english]D2L_DSL_256k"	"DSL > 256kbps"
"D2L_DSL_768k"	"DSL，速度高于768kbps"
"[english]D2L_DSL_768k"	"DSL > 768kbps"
"D2L_CABLEDSL_2M"	"DSL/CABLE > 2Mbps"
"[english]D2L_CABLEDSL_2M"	"DSL/Cable > 2Mbps"
"D2L_CABLEFIBER_10M"	"Cable/Fiber > 10Mbps"
"[english]D2L_CABLEFIBER_10M"	"Cable/Fiber > 10Mbps"
"D2L_NoBetaChosen"	"未参与\n（目前有 %numbetas% 项测试可用 ）"
"[english]D2L_NoBetaChosen"	"Not participating\n(%numbetas% currently available)"
"D2L_NoBetaChosenNonAdmin"	"%numbetas% 项测试可用\n(只有安装了Dota 2启动器的用户才能更改测试参与)"
"[english]D2L_NoBetaChosenNonAdmin"	"%numbetas% currently available\n(Only the user who installed Dota 2 Launcher can change Beta participation.)"
"D2L_UserCantSetBeta"	"%electedbeta%\n(只有安装了Dota 2启动器的用户才能更改测试参与)"
"[english]D2L_UserCantSetBeta"	"%electedbeta%\n(Only the user who installed Dota 2 Launcher can change Beta participation.)"
"D2L_MustRestartToTakeEffect"	"此设置将在您重启\n Dota 2启动器后生效"
"[english]D2L_MustRestartToTakeEffect"	"This setting will not take effect until\nyou have restarted Dota 2 Launcher."
"D2L_MustRestart_Title"	"Dota 2启动器 - 需要重启"
"[english]D2L_MustRestart_Title"	"Dota 2 Launcher - Restart required"
"D2L_Downloads_TimeRemaining"	"剩余时间"
"[english]D2L_Downloads_TimeRemaining"	"Time Remaining"
"D2L_Downloads_Pause"	"暂停"
"[english]D2L_Downloads_Pause"	"Pause"
"D2L_Downloads_Resume"	"继续"
"[english]D2L_Downloads_Resume"	"Resume"
"D2L_Downloads_Initiated"	"开始时间 "
"[english]D2L_Downloads_Initiated"	"Time Initiated"
"D2L_Downloads_GameSize_Update"	"已更新 "
"[english]D2L_Downloads_GameSize_Update"	"Updated"
"D2L_Downloads_DownloadRate"	"下载速度 "
"[english]D2L_Downloads_DownloadRate"	"Download Rate"
"D2L_ChooseBetaDlgTitle"	"参与测试 - Dota 2 启动器"
"[english]D2L_ChooseBetaDlgTitle"	"Beta Participation - Dota 2 Launcher"
"D2L_ChooseBetaExplanation"	"Dota 2通常会在正式发布以前提供测试启动器更新的机会。若要参加到这些测试项目中，请在下面的列表中选择一项并点击“OK”。(若想取消您的测试项目，请清空您的选择。)"
"[english]D2L_ChooseBetaExplanation"	"Dota 2 often offers the opportunity to try out launcher updates before they're officially released. To join one of these beta programs, select it from the list below and click 'OK'. (To remove yourself from all beta programs, select NONE.)"
"D2L_ReadMoreAboutBetas"	"了解更多Dota 2启动器测试的信息"
"[english]D2L_ReadMoreAboutBetas"	"Read more about how Dota 2 launcher betas work"
"D2L_IWantToChangePassword"	"我想修改我的密码。"
"[english]D2L_IWantToChangePassword"	"I want to change my password."
"D2L_IWantToChangeSecretQuestion"	"我想修改我的机密问题。"
"[english]D2L_IWantToChangeSecretQuestion"	"I want to change my secret question."
"D2L_ChangePasswordOrSecret"	"您要更改哪一项？"
"[english]D2L_ChangePasswordOrSecret"	"Which item would you like to change?"
"D2L_VisitSteamSupport"	"访问Dota 2客服以求助"
"[english]D2L_VisitSteamSupport"	"Visit Dota 2 support for assistance"
"D2L_LockAccount_Details"	" "
"[english]D2L_LockAccount_Details"	""
"D2L_TroubleshooterLink"	"到Dota 2客服页面查看更多信息"
"[english]D2L_TroubleshooterLink"	"See the Dota 2 support site for more information"
"D2L_ManageSecurity_DoNothing"	"明智的选择！当您在另一台电脑上登陆Dota 2时，您需要进入您的电子邮箱来完成，当您启用Dota 2令牌后您的账号将会更安全。"
"[english]D2L_ManageSecurity_DoNothing"	"Good choice! While you will need access to your email to login to Dota 2 on another computer, your account will be more secure with Dota 2 Guard enabled."
"D2L_ManageSecurity_DoNothing2"	"为了您的账户安全，请确定您Dota 2账号和邮箱的密码是不同的。"
"[english]D2L_ManageSecurity_DoNothing2"	"For your security, please be sure your Dota 2 account and email address passwords differ."
"D2L_ManageSecurity_InfoLabel"	"您的Dota 2账户正在Dota 2令牌的保护下，这可避免您的账号落入他人之手。"
"[english]D2L_ManageSecurity_InfoLabel"	"Your Dota 2 account is now protected by Dota 2 Guard, to protect your account from falling into the wrong hands."
"D2L_ManageSecurity_InfoLabel2"	"这意味着要使用未经授权的电脑或浏览器登录您的Dota 2帐号，您需要登录您的联系电子邮件帐号。"
"[english]D2L_ManageSecurity_InfoLabel2"	"This means you will need access to your contact email account in order to access your Dota 2 account from an unrecognized computer or browser."
"D2L_ManageSecurity_InfoLabel3"	"当您第一次通过一台未识别的电脑或浏览器登录时，Dota 2将会向您的联系电子邮件地址发送一则信息。该信息里将包含一枚特殊的验证码，您在登录Dota 2账号时会被要求输入此验证码。"
"[english]D2L_ManageSecurity_InfoLabel3"	"Dota 2 will send a message to your contact email address the first time you attempt to access your Dota 2 account from an unrecognized computer or browser. This message will include a special access code, which will be required in order to access your Dota 2 account."
"D2L_ManageSecurity_NothingRadio"	"保持Dota 2令牌对我的账号的保护"
"[english]D2L_ManageSecurity_NothingRadio"	"Keep my account protected by Dota 2 Guard"
"D2L_ManageSecurity_UnlockRadio"	"禁用Dota 2令牌(不推荐)"
"[english]D2L_ManageSecurity_UnlockRadio"	"Disable Dota 2 Guard (Not Recommended)"
"D2L_ManageSecurity_EnableIPT"	"已受到英特尔 ID 保护"
"[english]D2L_ManageSecurity_EnableIPT"	"Enable Intel Identity Protection"
"D2L_ManageSecurity_RemoveOtherComputersButton"	"现在取消授权其他的电脑"
"[english]D2L_ManageSecurity_RemoveOtherComputersButton"	"Deauthorize all other computers now"
"D2L_ManageSecurity_NotLockedInfo"	"您可以将您的Dota 2账号置于Dota 2令牌的保护之下，来防止您的账号落入他人之手。"
"[english]D2L_ManageSecurity_NotLockedInfo"	"Your Dota 2 account can be protected by Dota 2 Guard, to protect your account from falling into the wrong hands."
"D2L_ManageSecurity_NotLockedInfo2"	"在启用了Dota 2令牌的情况下，当您第一次通过一台未识别的电脑或浏览器登录时，Dota 2将会向您的联系电子邮件地址发送一则信息。该信息里将包含一枚特殊的验证码，您在登录Dota 2账号时会被要求输入此验证码。"
"[english]D2L_ManageSecurity_NotLockedInfo2"	"With Dota 2 Guard, Dota 2 will send a message to your contact email address the first time you attempt to access your Dota 2 account from an unrecognized computer or browser. This message will include a special access code, which will be required in order to access your Dota 2 account."
"D2L_ValidateEmailNotReceived"	"没有收到我们的信息？"
"[english]D2L_ValidateEmailNotReceived"	"Didn't receive our message?"
"D2L_ValidateEmailDescription"	"点击‘下一步’来验证您的Dota 2电子邮件地址。\n已验证的地址将用于确认Dota 2帐号凭据的任何变更，因此您且只有您才可以更改密码提示问题或密码。"
"[english]D2L_ValidateEmailDescription"	"Click ‘Next’ to verify your email address with Dota 2.\nA verified address will be used to confirm any changes to your Dota 2 account credentials, so you and only you can change your secret question or password."
"D2L_ValidateEmailDescriptionAlt"	"您的电子邮件地址尚未验证。\n点击‘下一步’来验证您的Dota 2电子邮件地址。\n已验证的地址将用于确认Dota 2帐号凭据的任何变更，因此您且只有您才可以更改密码提示问题或密码。"
"[english]D2L_ValidateEmailDescriptionAlt"	"Your email address is not verified.\nClick ‘Next’ to verify your email address with Dota 2.\nA verified address will be used to confirm any changes to your Dota 2 account credentials, so you and only you can change your secret question or password."
"D2L_RecoverLocked_Info"	"您好！我们发现您正在从一台新电脑登录。"
"[english]D2L_RecoverLocked_Info"	"Hello! We see you're logging in from a new computer."
"D2L_RecoverLocked_UseCode"	"我已经收到了Dota 2的信息并且准备好输入我的验证码了。"
"[english]D2L_RecoverLocked_UseCode"	"I've received the message from Dota 2 and am ready to enter my special access code."
"D2L_RecoverLocked_WhyIsThisHappening"	"为什么会这样呢？"
"[english]D2L_RecoverLocked_WhyIsThisHappening"	"Why is this happening?"
"D2L_RecoverLocked_NoEmail"	"您有检查过您的垃圾邮件文件夹吗？"
"[english]D2L_RecoverLocked_NoEmail"	"Did you check your spam folder?"
"D2L_RecoverLocked_NoEmailDetails"	"如果您没有在收件箱中找到Dota 2发出的邮件，请尝试在您的垃圾邮件中寻找。"
"[english]D2L_RecoverLocked_NoEmailDetails"	"If you don't see a recent message from Dota 2 in your inbox, try looking in your email account's spam folder."
"D2L_RecoverLocked_NoEmailDetails2"	"如果您找到了就回来输入您的验证码，或者如果您想通过此计算机访问Dota 2 帐号，点击下一步来获取帮助。"
"[english]D2L_RecoverLocked_NoEmailDetails2"	"Go back to enter your code if you've found it, or click Next to get the help you'll need to access your Dota 2 account from this computer."
"D2L_RecoverLocked_StartRecovery"	"对您遇到问题致歉 - 让我们来帮助您吧！"
"[english]D2L_RecoverLocked_StartRecovery"	"Sorry you're having trouble - let us help!"
"D2L_RecoverLocked_StartRecovery2"	"我们很清楚Dota 2账号对您来说很重要，我们也一直致力于保护您的账号安全。"
"[english]D2L_RecoverLocked_StartRecovery2"	"We know your Dota 2 account is valuable to you, and we're committed to helping you keep access to it in the right hands."
"D2L_RecoverLocked_StartRecovery3"	"请通过联系Dota 2客服来让我们的员工协助您。对账号的权限合理求助永远是您的首选。"
"[english]D2L_RecoverLocked_StartRecovery3"	"Please contact Dota 2 Support to have a member of our staff assist you. Legitimate claims for help with account access are our number one priority."
"D2L_RecoverLocked_RecoverySupportLink"	"联系Dota 2客服"
"[english]D2L_RecoverLocked_RecoverySupportLink"	"Contact Dota 2 Support"
"D2L_RecoverLocked_ResultWorking"	"Dota 2 - 正在处理"
"[english]D2L_RecoverLocked_ResultWorking"	"Dota 2 - working"
"D2L_RecoverLocked_Success"	"成功！"
"[english]D2L_RecoverLocked_Success"	"Success!"
"D2L_RecoverLocked_SuccessDetails"	"您现在可以通过此计算机来访问您的Dota 2帐号了。Dota 2令牌已经把此计算机列入了在将来准许访问您Dota 2帐号的设备列表。"
"[english]D2L_RecoverLocked_SuccessDetails"	"You now have access to your Dota 2 account from this computer. Dota 2 Guard has added this computer to the list of machines that are allowed to access your Dota 2 account in the future."
"D2L_RememberThisComputer"	"记住这台电脑？"
"[english]D2L_RememberThisComputer"	"Remember this computer?"
"D2L_SSA_Agree"	"请完整阅读此协议。您必须在同意Dota 2用户协议中的条款后才能进行下一步。"
"[english]D2L_SSA_Agree"	"Please read this agreement in its entirety. You must agree with the terms of the Dota 2 Subscriber Agreement to continue."
"D2L_ClickToPrint"	"单击此处打印"
"[english]D2L_ClickToPrint"	"Click here to print"
"D2L_Legal_SSANext"	"我同意"
"[english]D2L_Legal_SSANext"	"I Agree"
"D2L_Legal_SSADisagree"	"我不同意"
"[english]D2L_Legal_SSADisagree"	"I Disagree"
"D2L_RefreshLogin_InfoTicketExpired"	"您的Dota 2票已过期。\n请重新输入您的密码以继续。"
"[english]D2L_RefreshLogin_InfoTicketExpired"	"Your Dota 2 ticket has expired.\nPlease re-enter your password to continue."
"D2L_Login_RememberPassword"	"记住我的密码"
"[english]D2L_Login_RememberPassword"	"Remember my password"
"D2L_Login_Btn"	"登录"
"[english]D2L_Login_Btn"	"Login"
"D2L_AccountName"	"帐号名称"
"[english]D2L_AccountName"	"Account name"
"D2L_Login_Password"	"密码"
"[english]D2L_Login_Password"	"Password"
"D2L_Login_Cancel"	"取消"
"[english]D2L_Login_Cancel"	"Cancel"
"Steam_RefreshLogin_Title"	"Dota 2 - 刷新登陆"
"[english]Steam_RefreshLogin_Title"	"Dota 2 - Refresh Login"
"Steam_AccountAlreadyLoggedInNeedPassword"	"此账号已在别处登录。\n重新输入您的密码以在此电脑上登录。"
"[english]Steam_AccountAlreadyLoggedInNeedPassword"	"This account is currently logged in elsewhere.\nRe-enter your password to login on this computer."
"Steam_AccountAlreadyLoggedInNeedShutdown"	"您的账号“%account%”正在另一台设备上被使用。\n您需要关闭其他设备上的Dota 2才能在此电脑上登录。"
"[english]Steam_AccountAlreadyLoggedInNeedShutdown"	"Your account '%account%' is currently in use at another machine.\nYou'll need to shut down Dota 2 on your other computer in order to log in here."
"Steam_RefreshLogin_InvalidPassword"	"您的账号凭证已过期。\n请重新输入您的密码以继续。"
"[english]Steam_RefreshLogin_InvalidPassword"	"Your account credentials have expired.\nPlease re-enter your password to continue."
"Steam_RefreshLogin_PurchaseSecurity"	"出于安全考虑，您需要重新输入密码才能继续。"
"[english]Steam_RefreshLogin_PurchaseSecurity"	"For security reasons, it is required that you re-enter your password to continue."
"Steam_RefreshLogin_InfoTicketExpired"	"您的Dota 2票已过期。\n请重新输入您的密码以继续。"
"[english]Steam_RefreshLogin_InfoTicketExpired"	"Your Dota 2 ticket has expired.\nPlease re-enter your password to continue."
"Steam_Login_ErrorTitle"	"Dota 2 - 错误"
"[english]Steam_Login_ErrorTitle"	"Dota 2 - Error"
"Steam_ErrorLoginFailed"	"登录Dota 2失败。\n可能账户不存在，或者密码错误。\n请确认您的账户名和密码是否正确再重试。"
"[english]Steam_ErrorLoginFailed"	"Login to Dota 2 failed.\nEither the specified account does not exist, or the password was wrong.\nPlease check your account name and password and try again."
"Steam_LaunchingSteam"	"正在连接到Dota 2账户%s1..."
"[english]Steam_LaunchingSteam"	"Connecting Dota 2 account %s1..."
"Steam_UpdatingTitle"	"Dota 2启动器"
"[english]Steam_UpdatingTitle"	"Dota 2 Launcher"
"Steam_UpdatingSteamPlatformFiles"	"正在更新Dota 2启动器文件..."
"[english]Steam_UpdatingSteamPlatformFiles"	"Updating Dota 2 Launcher files..."
"Steam_ExitingSteam"	"退出中..."
"[english]Steam_ExitingSteam"	"Exiting ..."
"SteamUI_ValidateEmailDescriptionAlt"	"您的电子邮件地址尚未验证。\n点击‘下一步’来验证您的Dota 2电子邮件地址。\n已验证的地址将用于确认Dota 2帐号凭据的任何变更，因此您且只有您才可以更改密码提示问题或密码。"
"[english]SteamUI_ValidateEmailDescriptionAlt"	"Your email address is not verified.\nClick ‘Next’ to verify your email address with Dota 2.\nA verified address will be used to confirm any changes to your Dota 2 account credentials, so you and only you can change your secret question or password."
"Steam_ChangeContactEmailError_SteamNotAvailable2"	"Dota 2现在无法处理您的请求。\n请稍后再试。"
"[english]Steam_ChangeContactEmailError_SteamNotAvailable2"	"Dota 2 cannot currently process your request.\nPlease try again later."
"SteamUI_ValidateEmailWorking"	"正在联系Dota 2服务器以发送邮件。"
"[english]SteamUI_ValidateEmailWorking"	"Contacting Dota 2 Servers to send email."
"SteamUI_VerifyEmail_Title"	"验证电子邮件"
"[english]SteamUI_VerifyEmail_Title"	"Verify Email"
"SteamUI_LockAccount_Success"	" "
"[english]SteamUI_LockAccount_Success"	""
"SteamUI_LockAccount_Title"	" "
"[english]SteamUI_LockAccount_Title"	""
"SteamUI_ManageSecurity_SandybridgeActivated"	"已验证英特尔 ID 保护。\n正连接服务器来注册此电脑。"
"[english]SteamUI_ManageSecurity_SandybridgeActivated"	"Intel Identity Protection verified.\nNow contacting server to register this computer."
"SteamUI_ManageSecurity_SandybridgeFailed"	"英特尔 ID 保护初始化失败。\n请验证软件的安装。"
"[english]SteamUI_ManageSecurity_SandybridgeFailed"	"Intel Identity Protection failed to initialize.\nPlease verify software installation."
"SteamUI_ManageSecurity_InfoLabel"	"您的Dota 2账户正在Dota 2令牌的保护下，这可避免您的账号落入他人之手。"
"[english]SteamUI_ManageSecurity_InfoLabel"	"Your Dota 2 account is now protected by Dota 2 Guard, to protect your account from falling into the wrong hands."
"SteamUI_ManageSecurity_InfoLabel2"	"这意味着要使用未经授权的电脑或浏览器登录您的Dota 2帐号，您需要登录您的联系电子邮件帐号。"
"[english]SteamUI_ManageSecurity_InfoLabel2"	"This means you will need access to your contact email account in order to access your Dota 2 account from an unrecognized computer or browser."
"SteamUI_ManageSecurity_UnlockAccount_Success"	"只要是提供了您的帐号名称和密码，任何计算机或浏览器都能使用您的Dota 2帐号。"
"[english]SteamUI_ManageSecurity_UnlockAccount_Success"	"Any computer or browser may now have access to your Dota 2 account, provided your account name and password are provided."
"SteamUI_ManageSecurity_Reenable"	"欲重新启用Dota 2令牌，可点击Dota 2设置中的“管理Dota 2令牌帐号安全”。"
"[english]SteamUI_ManageSecurity_Reenable"	"To re-enable Dota 2 Guard, click 'Manage Dota 2 Guard Account Security' in Dota 2 Launcher Settings."
"SteamUI_ManageSecurity_CodeSent"	"一封带有代码的邮件已发送到您的电子邮件中。\n当您用一台新电脑登录时请使用这个代码。"
"[english]SteamUI_ManageSecurity_CodeSent"	"An email with a code has been sent to your email address.\nUse this code when you login on a new computer."
"SteamUI_ManageSecurity_OtherComputersDenied"	"在未经您已验证邮箱的同意下，所有其他的计算机都不再被许可访问该Dota 2帐号。"
"[english]SteamUI_ManageSecurity_OtherComputersDenied"	"All other computers are no longer authorized to access this Dota 2 account without your prior consent via email."
"SteamUI_ManageSecurity_OtherComputersDenied2"	"想在其他电脑登录Dota 2，您需要输入我们在您尝试登录时发到您邮箱的独特验证码。"
"[english]SteamUI_ManageSecurity_OtherComputersDenied2"	"To login to Dota 2 on another computer, you'll be required to enter a unique access code which we'll send to your email address when you attempt to login."
"SteamUI_ManageSecurity_IPTRegistrationComplete"	"英特尔 IPT 保护现在已经激活。\n只有此计算机可以访问该Dota 2帐号。"
"[english]SteamUI_ManageSecurity_IPTRegistrationComplete"	"Intel Identity Protection is now active.\nOnly this computer may access this Dota 2 account."
"SteamUI_ManageSecurity_Working"	"正在联系Dota 2服务器以执行请求..."
"[english]SteamUI_ManageSecurity_Working"	"Contacting Dota 2 Servers to perform request..."
"SteamUI_SteamGuardProviderEmail"	"电子邮件"
"[english]SteamUI_SteamGuardProviderEmail"	"Email"
"SteamUI_SteamGuardProviderMobile"	"Dota 2移动客户端"
"[english]SteamUI_SteamGuardProviderMobile"	"Dota 2 Mobile Client"
"SteamUI_ManageSecurity_InfoLabel_LockedWithIPT"	"此帐号已被英特尔 IPT 保护，而且只允许通过此计算机来访问。"
"[english]SteamUI_ManageSecurity_InfoLabel_LockedWithIPT"	"This account has Intel Identity Protection and may only be accessed from this computer."
"SteamUI_ManageSecurity_RemoveIPT"	"移除英特尔 ID 保护"
"[english]SteamUI_ManageSecurity_RemoveIPT"	"Remove Intel Identity Protection"
"Steam_Shutdown_Waiting_For_Logoff"	"注销中 ..."
"[english]Steam_Shutdown_Waiting_For_Logoff"	"Logging off ..."
"Steam_Shutdown_Waiting_For_Game"	"正在等待 %game% 结束 ..."
"[english]Steam_Shutdown_Waiting_For_Game"	"Waiting for %game% to shut down ..."
"Steam_Shutdown_Waiting_For_Cloud"	"正在结束Dota 2云同步..."
"[english]Steam_Shutdown_Waiting_For_Cloud"	"Finishing Dota 2 cloud sync ..."
"Steam_Shutdown_Waiting_For_Download"	"正在停止下载 %game% ..."
"[english]Steam_Shutdown_Waiting_For_Download"	"Stopping download for %game% ..."
"Steam_LogoutDialogMsg"	"这会使您登出Dota 2。您将会需要重新输入\n帐号名称和密码才能再次使用Dota 2。\n\n是否继续？"
"[english]Steam_LogoutDialogMsg"	"This will log you out of Dota 2. You will need to re-enter\nyour account name and password to use Dota 2 again.\n\nDo you wish to continue?"
"Steam_CacheValidation_Title"	"验证Dota 2文件 - 已完成 %progress%%%"
"[english]Steam_CacheValidation_Title"	"Validating Dota 2 files - %progress%%% complete"
"Steam_ValidatingSteamCaches_Label"	"正在验证Dota 2启动器缓存文件（%cache_number%/%cache_total%）"
"[english]Steam_ValidatingSteamCaches_Label"	"Validating Dota 2 Launcher cache files (%cache_number% of %cache_total%)"
"Steam_ChangePasswordWizard_Title"	"Dota 2 - 密码更改助手"
"[english]Steam_ChangePasswordWizard_Title"	"Dota 2 - Change Password Wizard"
"Steam_ChangePasswordSuccessful"	"您的密码已成功更改。\n请在以后每次登录Dota 2时使用此新密码。"
"[english]Steam_ChangePasswordSuccessful"	"Your password has been successfully changed.\nPlease use this new password each time you log into Dota 2."
"Steam_ChangeContactEmailWizard_Contact"	"该新电子邮件地址将用于确认今后的购买并帮助您管理对Dota 2帐号的访问。"
"[english]Steam_ChangeContactEmailWizard_Contact"	"This new address will be used to confirm future purchases and help you manage access to your Dota 2 account."
"Steam_ChangeContactEmailWizard_NotChangedYet"	"正在联系Dota 2服务器以发送确认码至您所提出的新电子邮件地址。"
"[english]Steam_ChangeContactEmailWizard_NotChangedYet"	"Contacting Dota 2 servers to send a confirmation code to your proposed new email address."
"Steam_ChangeCred_EmailProgress"	"正在联系Dota 2服务器以将确认消息发送至 %s1。"
"[english]Steam_ChangeCred_EmailProgress"	"Contacting Dota 2 servers to send a confirmation message to %s1."
"SteamUI_SteamProgress_Title"	"Dota2 - 正在运行"
"[english]SteamUI_SteamProgress_Title"	"Dota2 - Working"
"Steam_LockedAccountRecover_Title"	"Dota 2令牌 - 电脑需要授权"
"[english]Steam_LockedAccountRecover_Title"	"Dota 2 Guard - Computer Authorization Required"
"Steam_RecoverLocked_MustRecover"	"什么消息？我没收到..."
"[english]Steam_RecoverLocked_MustRecover"	"What email message? I don't have it..."
"Steam_RecoverLocked_EnterCode"	"我的特殊验证码是："
"[english]Steam_RecoverLocked_EnterCode"	"My special access code is:"
"Steam_RecoverLocked_EnterCodeDetails"	"一旦您验证了代码，Dota 2令牌将把此计算机加入允许访问您Dota 2帐号的设备列表。"
"[english]Steam_RecoverLocked_EnterCodeDetails"	"Once your code has been verified, Dota 2 Guard will add this computer to the list of machines that are allowed to access your Dota 2 account."
"SteamUI_SteamGuardDontRemember"	"如果您的帐号需要重新在此计算机上登录，您需要重新输入验证码。"
"[english]SteamUI_SteamGuardDontRemember"	"You will need to enter the code again if you want to log in to your account on this computer again."
"D2L_VerifyContactEmail"	"验证电子邮件地址..."
"[english]D2L_VerifyContactEmail"	"Verify email address..."
"D2L_RecoverLocked_MustRecover"	"什么消息？我没收到…"
"[english]D2L_RecoverLocked_MustRecover"	"What email message? I don't have it..."
"D2L_LanguageSelect"	"选择您希望Dota 2使用的语言（需要重新启动Dota 2）"
"[english]D2L_LanguageSelect"	"Select the language you wish Dota 2 to use (requires Dota 2 to restart)"
"D2L_MustRestart_Button"	"重新开始"
"[english]D2L_MustRestart_Button"	"Restart"
"D2L_Login_Title"	"Dota 2 - 登录"
"[english]D2L_Login_Title"	"Dota 2 - Login"
"D2L_ActivateProduct" "在 Dota 2 上激活产品..."
"[english]D2L_ActivateProduct"	"Activate a Product"
"D2L_Login_CapsLockWarning"	"已开启大写锁定"
"[english]D2L_Login_CapsLockWarning"	"Caps Lock On"
"D2L_Login_CreateNewAccount"	"创建一个新的帐号..."
"[english]D2L_Login_CreateNewAccount"	"Create a new account..."
"D2L_Login_RetrievePassword"	"取回丢失的帐号..."
"[english]D2L_Login_RetrievePassword"	"Retrieve a lost account..."
"D2L_Login_NoAccount"	"没有Dota 2账号？"
"[english]D2L_Login_NoAccount"	"Don't have a Dota 2 account?"
"D2L_Login_ForgotPassword"	"忘记您的登录信息？"
"[english]D2L_Login_ForgotPassword"	"Forgot your login info?"
"D2L_AccountAlreadyLoggedInNeedPassword"	"此帐号当前正在其它地方登录。重新输入您的密码来在此计算机上登录。"
"[english]D2L_AccountAlreadyLoggedInNeedPassword"	"This account is currently logged in elsewhere.\nRe-enter your password to login on this computer."
"D2LGuardBanner"	"带有 Intel® 身份保护技术（简称 IPT）的Dota 2令牌"
"[english]D2LGuardBanner"	"Dota 2 Guard with Intel® Identity Protection Technology"
"D2L_ErrorAccountDisabled"	"Dota 2客服已暂时禁用该帐号。\n\n造成帐号被暂时禁用的原因通常是\n帐号被其他人访问，或者是存在交易纠纷。"
"[english]D2L_ErrorAccountDisabled"	"Dota 2 Support has suspended this account.\n\nAccounts typically become suspended when an account has been accessed\nby someone else, or a payment dispute is in progress."
"D2L_Login_DisabledTitle"	"Dota 2 - 请联系我们"
"[english]D2L_Login_DisabledTitle"	"Dota 2 - Contact us"
"D2L_Login_ContactSupport"	"请联系Dota 2客服来解决这一问题。"
"[english]D2L_Login_ContactSupport"	"Please contact Dota 2 Support to resolve this issue."
"D2L_Login_ErrorTitle"	"Dota 2 - 错误"
"[english]D2L_Login_ErrorTitle"	"Dota 2 - Error"
"D2L_AccountAlreadyLoggedInNeedShutdown"	"您的帐号 '%account%' 当前正在其它计算机上使用。\n您需要在其它计算机上关闭Dota 2后，才能在本计算机上登录。"
"[english]D2L_AccountAlreadyLoggedInNeedShutdown"	"Your account '%account%' is currently in use at another machine.\nYou'll need to shut down Dota 2 on your other computer in order to log in here."
"D2L_ErrorLoginFailed"	"登录Dota 2失败。\n您的帐号可能不存在，或者是密码错误。\n请检查您的帐号名称和密码并重试。"
"[english]D2L_ErrorLoginFailed"	"Login to Dota 2 failed.\nEither the specified account does not exist, or the password was wrong.\nPlease check your account name and password and try again."
"D2L_ErrorAccountIPLoginRestricted"	"此帐号在该地区无法使用。\n"
"[english]D2L_ErrorAccountIPLoginRestricted"	"This account can not be accessed from this location.\n"
"D2L_WelcomeToSteamInfo"	"欢迎来到DOTA2"
"[english]D2L_WelcomeToSteamInfo"	"Welcome to Dota 2"
"D2L_WelcomeToSteamCreateAccount"	"创建一个新的帐号"
"[english]D2L_WelcomeToSteamCreateAccount"	"Create new account"
"D2L_WelcomeToSteamLogin"	"使用已有账号登录"
"[english]D2L_WelcomeToSteamLogin"	"Login with an existing account"
"D2L_ChosenCreateDuplicate"	"请务必仅在没有Dota 2帐号的情况下再创建新的帐号。\n\n如果没有Dota 2帐号，请单击“下一步”以继续。"
"[english]D2L_ChosenCreateDuplicate"	"Please only create a new Dota 2 account if you don't already have one. \n\nIf you don't already have a Dota 2 account, press \"Next\" to continue."
"D2L_ChosenCreateMultipleHeadline"	"关于Dota 2账号的重要信息"
"[english]D2L_ChosenCreateMultipleHeadline"	"Important information about Dota 2 accounts"
"Steam_Working_Title"	"Dota2 - 工作中"
"[english]Steam_Working_Title"	"Dota2 - Working"
"Steam_Tooltip_Working"	"Dota2 - 工作中"
"[english]Steam_Tooltip_Working"	"Dota2 - Working"
"Steam_ForgottenPassword_Title"	"获取帐号信息 - Dota 2"
"[english]Steam_ForgottenPassword_Title"	"Retrieve Account Info - Dota 2"
"Steam_ForgottenPassword_RequestFailed"	"操作失败。 请重试。"
"[english]Steam_ForgottenPassword_RequestFailed"	"The operation failed. Please try again."
"Steam_RecoverLocked_ResultWorking"	"Dota2 - 工作中"
"[english]Steam_RecoverLocked_ResultWorking"	"Dota2 - Working"
"SteamUI_CreateAccount_Title"	"创建一个Dota 2账号"
"[english]SteamUI_CreateAccount_Title"	"Create a Dota 2 Account"
"Steam_UserNameTooShort"	"您的帐号名称长度应该至少有 3 个字符。"
"[english]Steam_UserNameTooShort"	"Your account name must be at least 3 characters long."
"Steam_UserNameInvalidSpaces"	"您的帐号名称不能包含空格。"
"[english]Steam_UserNameInvalidSpaces"	"Your account name may not contain any spaces."
"Steam_UserNameTooLong"	"您的账户名长度不得多于64位。"
"[english]Steam_UserNameTooLong"	"Your account name must be fewer than 64 characters long."
"Steam_UserNameInvalid"	"您的帐号名称包含无效字符。\n仅允许包含字母、数字和下划线（_）。"
"[english]Steam_UserNameInvalid"	"Your account name contains invalid characters.\nOnly letters, numbers and _ are allowed."
"Steam_UserNameReserved"	"您的帐号名称不能包含“Valve”或“Steam”。"
"[english]Steam_UserNameReserved"	"Your account name may not contain 'Valve' or 'Steam'."
"Steam_ErrorPasswordTooShort2"	"您的密码必须至少有 8 个字符的长度。"
"[english]Steam_ErrorPasswordTooShort2"	"Your password must be at least 8 characters long."
"Steam_ErrorPasswordTooLong2"	"您的密码长度不得多于64位。"
"[english]Steam_ErrorPasswordTooLong2"	"Your password must be fewer than 64 characters long."
"Steam_GuestPassAccept_TextServiceUnavailable"	"您的计算机当前无法访问Dota 2服务器，或暂时无法使用服务。 请稍后再试。"
"[english]Steam_GuestPassAccept_TextServiceUnavailable"	"Your computer is either currently unable to reach the Dota 2 servers, or the service may be temporarily disabled. Please try again later."
"SteamUI_WelcomeCreatingAccount_Failure_Title"	"Dota 2 - 创建账号失败"
"[english]SteamUI_WelcomeCreatingAccount_Failure_Title"	"Dota 2 - Create Account Failed"
"Steam_ErrorValidEmailRequired"	"需要一个有效的电子邮件地址。"
"[english]Steam_ErrorValidEmailRequired"	"A valid email address is required."
"Steam_ErrorEnteredEmailMismatch"	"电子邮件地址不匹配。\n请确保此电子邮件地址和确认用的电子邮件地址一致。"
"[english]Steam_ErrorEnteredEmailMismatch"	"The email addresses did not match.\nPlease ensure the email address and confirmation email address match exactly."
"Steam_AccountEmail_Title"	"Dota 2账号信息"
"[english]Steam_AccountEmail_Title"	"Dota 2 Account Information"
"Steam_AccountEmail_Info"	"建议您打印此信息并妥善保存。您的Dota 2帐号和登录信息非常重要——从现在起，您将需要它们来访问Dota 2。"
"[english]Steam_AccountEmail_Info"	"It is recommended that you print this information and keep it in a safe place. Your Dota 2 account and login information is important--from now on, you'll need it to access Dota 2."
"Steam_AccountEmail_AccountName"	"帐号名称："
"[english]Steam_AccountEmail_AccountName"	"Account Name:"
"Steam_AccountEmail_Password"	"密码："
"[english]Steam_AccountEmail_Password"	"Password:"
"Steam_AccountEmail_Email"	"联系电子邮件地址："
"[english]Steam_AccountEmail_Email"	"Contact email address:"
"Steam_AccountEmail_Print"	"单击此处马上打印此页面"
"[english]Steam_AccountEmail_Print"	"Click here to print this page now"
"SteamUI_CreateAccount_Names"	"名称"
"[english]SteamUI_CreateAccount_Names"	"Names"
"SteamUI_SecretQuestion1"	"您母亲姓什么？"
"[english]SteamUI_SecretQuestion1"	"What is your mother's maiden name?"
"SteamUI_SecretQuestion2"	"您的宠物的名字是什么？"
"[english]SteamUI_SecretQuestion2"	"What is the name of your pet?"
"SteamUI_SecretQuestion3"	"童年时期心目中的英雄是谁？"
"[english]SteamUI_SecretQuestion3"	"Who was your childhood hero?"
"SteamUI_SecretQuestion4"	"您出生在哪个城市？"
"[english]SteamUI_SecretQuestion4"	"What city were you born in?"
"SteamUI_SecretQuestion5"	"您所在学校的名字是？"
"[english]SteamUI_SecretQuestion5"	"What is the name of your school?"
"SteamUI_SecretQuestion6"	"您最喜欢的球队是？"
"[english]SteamUI_SecretQuestion6"	"What is your favorite team?"
"SteamUI_CreateAccount_Error"	"Dota 2 - 创建账号出错"
"[english]SteamUI_CreateAccount_Error"	"Dota 2 - Create account error"
"Steam_ErrorAnswerTooShort"	"密保问题的答案长度\n至少需要3位"
"[english]Steam_ErrorAnswerTooShort"	"The answer to the secret question\nmust be at least 3 characters long."
"SteamUI_AccountNameInUse"	"创建帐号失败。\n帐号名称已被使用。\n请输入其他的帐号名称重试。"
"[english]SteamUI_AccountNameInUse"	"Failed to create account.\nThat account name is already in use.\nPlease try again using a different account name."
"SteamUI_CreateAccountFailedPasswordIllegal"	"创建帐号失败。\n该密码不满足额外的复杂性要求。请重新选择。"
"[english]SteamUI_CreateAccountFailedPasswordIllegal"	"Failed to create account.\nThat password did not satisfy additional complexity requirements. Please choose again."
"SteamUI_CreatingAccount"	"正在创建帐号..."
"[english]SteamUI_CreatingAccount"	"Creating account..."
"SteamUI_WelcomeCreatingAccount_Title"	"Dota 2 - 创建账号"
"[english]SteamUI_WelcomeCreatingAccount_Title"	"Dota 2 - Create Account"
"SteamUI_WelcomeCreatingAccount_Failed"	"创建帐号失败。\n点击“后退”以重试或者点击“取消”以退出。"
"[english]SteamUI_WelcomeCreatingAccount_Failed"	"Create account failed.\nHit Back to try again or Cancel to quit."
"SteamRoot_Title"	"Dota 2"
"[english]SteamRoot_Title"	"Dota 2"
"Steam_RetailInstallTitle"	"Dota 2 - 安装 %product%"
"[english]Steam_RetailInstallTitle"	"Dota 2 - Install %product%"
"SteamUI_WelcomeToSteam_Title"	"Dota 2"
"[english]SteamUI_WelcomeToSteam_Title"	"Dota 2"
"Steam_ErrorAccountDisabled"	"Dota 2客服已暂时禁用该帐号。\n\n造成帐号被暂时禁用的原因通常是\n帐号被其他人访问，或者是存在交易纠纷。"
"[english]Steam_ErrorAccountDisabled"	"Dota 2 Support has suspended this account.\n\nAccounts typically become suspended when an account has been accessed\nby someone else, or a payment dispute is in progress."
"Steam_ForgottenPassword_CouldNotFindEmail"	"帐号不存在。\n请输入您登录Dota 2的帐号名称。"
"[english]Steam_ForgottenPassword_CouldNotFindEmail"	"That account was not found.\nPlease enter the account name you use to log into Dota 2."
"Steam_ForgottenPassword_AuthorizationNoQuestion"	"一封包含有认证码的电子邮件\n刚刚发送到您所提供的地址。\n请检查您的电子邮件，\n然后在下面输入所需信息。"
"[english]Steam_ForgottenPassword_AuthorizationNoQuestion"	"An email message containing a verification code\nhas just been sent to the address you provided.\nPlease check your email,\nthen enter the requested information below."
"Steam_ForgottenPassword_Incorrect"	"您的密码无法进行修改。\n可能是您没有输入正确的验证码，或者是\n您填写了一个无效的新密码。\n\n请单击“返回”并重试。\n"
"[english]Steam_ForgottenPassword_Incorrect"	"Your password was not changed.\nEither you entered the validation code incorrectly,\nor your new password is invalid.\n\nPlease hit 'Back' and try again. \n"
"Steam_ForgottenPassword_SamePassword"	"新密码与当前的密码相同。点击返回选择一个新的密码或取消来使用这个密码\n\n"
"[english]Steam_ForgottenPassword_SamePassword"	"The new password matches the current password. Hit back to choose a new password or cancel and log in with that password\n"
"Steam_ChangePasswordFailedIllegal"	"更改密码失败。\n该密码不满足额外的复杂性要求。请重新选择。"
"[english]Steam_ChangePasswordFailedIllegal"	"Failed to change password.\nThat password did not satisfy additional complexity requirements. Please choose again."
"Steam_ChangePasswordFailedReuse"	"更改密码失败。\n您不能使用旧密码。请重新选择。"
"[english]Steam_ChangePasswordFailedReuse"	"Failed to change password.\nYou may not reuse an old password. Please choose again."
"Steam_ErrorPasswordTooShort"	"您的新密码必须有 8 个字符的长度。"
"[english]Steam_ErrorPasswordTooShort"	"Your new password must be at least 8 characters long."
"Steam_ErrorPasswordTooLong"	"您的新密码长度不得超过64位。"
"[english]Steam_ErrorPasswordTooLong"	"Your new password must be fewer than 64 characters long."
"Steam_ChangeContactEmailError_InvalidEmail"	"您输入的电子邮件地址\n格式无效。请重新输入。"
"[english]Steam_ChangeContactEmailError_InvalidEmail"	"The email address you entered is not in the \nformat of a valid address. Please try again."
"Steam_GetCDKeyError_Info"	"您输入的产品代码无效。 \n\n请仔细检查是否输错了序列号。\nI、L 和 1 看上去很相似，V 和 Y、0 和 O 亦是如此。 "
"[english]Steam_GetCDKeyError_Info"	"The product code you've entered is not valid. \n\nPlease double check to see if you've mistyped your key.\nI, L, and 1 can look alike, as can V and Y, and 0 and O."
"SteamUI_ForgottenPasswordSentEmailCDKey"	"您输入的产品代码的所有者将会收到一封电子邮件。当您获得此帐号名称后，可以使用“获取丢失的帐号”按钮来寻回密码。"
"[english]SteamUI_ForgottenPasswordSentEmailCDKey"	"An email has been sent to the owner of the product code you entered. Once you get this account name you can use the \"Retrieve lost account\" button again to reset your password."
"Steam_RecoverLocked_WrongCode"	"很抱歉，这不太对。"
"[english]Steam_RecoverLocked_WrongCode"	"Sorry, that isn't quite right."
"Steam_RecoverLocked_ExpiredCode"	"此验证码已过期。"
"[english]Steam_RecoverLocked_ExpiredCode"	"That code is too old and has expired."
"Steam_RecoverLocked_ExpiredCodeDetails"	"检查您的电子邮件收件箱是否有新接收到的邮件，然后点击“返回”以重试，或者点击“下一步”按钮请求发送新的验证码。"
"[english]Steam_RecoverLocked_ExpiredCodeDetails"	"Check your email folder for a more recent email and click back to try again, or click the next button to request a new email with a new code."
"Steam_RecoverLocked_WrongCodeDetails"	"回去再试试，或者如果您想通过此计算机访问Dota 2帐号，点击下一步来获取帮助。"
"[english]Steam_RecoverLocked_WrongCodeDetails"	"Go back to try again, or click Next to get the help you'll need to access your Dota 2 account from this computer."
"Steam_RecoverLocked_ResultFailure"	"连接Dota 2服务器失败"
"[english]Steam_RecoverLocked_ResultFailure"	"Failed to contact Dota 2 servers"
"Steam_RecoverLocked_ResultFailureDetails"	"Dota 2服务器现在无法连接。请稍后再试。"
"[english]Steam_RecoverLocked_ResultFailureDetails"	"The Dota 2 servers could not be contacted at this time. Please try again later."
"Steam_RecoverLocked_CannotAccess"	"抱歉，在没有进一步授权的情况下此账号无法在本计算机上登录。"
"[english]Steam_RecoverLocked_CannotAccess"	"Sorry, this account can't be accessed from this computer without additional authorization."
"Steam_RecoverLocked_StartRecovery"	"抱歉，您遇到问题了 - 让我们来帮忙！"
"[english]Steam_RecoverLocked_StartRecovery"	"Sorry you're having trouble - let us help!"
"SteamUI_SteamGuardUseMobile"	"使用Dota 2移动应用程序来提供您的Dota 2令牌验证码"
"[english]SteamUI_SteamGuardUseMobile"	"Use the Dota 2 Mobile application to provide your Dota 2 Guard code"
"SteamUI_SteamGuardUseMobile2"	"我的移动设备已准备就绪"
"[english]SteamUI_SteamGuardUseMobile2"	"I have my mobile device ready"
"SteamUI_SteamGuardUseMobile3"	"我的移动设备上已经没有Dota 2应用程序了.."
"[english]SteamUI_SteamGuardUseMobile3"	"I no longer have my mobile device with the Dota 2 Mobile application.."
"SteamUI_Invalid_Account_Name"	"无效的账号名"
"[english]SteamUI_Invalid_Account_Name"	"Invalid Account Name"
"SteamUI_Invalid_Email_Address"	"无效的电子邮件地址"
"[english]SteamUI_Invalid_Email_Address"	"Invalid Email Address"
"SteamUI_CreateAccount_TheName"	"此名称"
"[english]SteamUI_CreateAccount_TheName"	"The name"
"SteamUI_CreateAccount_AlreadyTaken"	"已被另一位Dota 2用户注册。"
"[english]SteamUI_CreateAccount_AlreadyTaken"	"has already been registered by another Dota 2 user."
"SteamUI_WelcomeCreatingAccountEnterName"	"请提供帐号名称和密码，\n为了确保密码不被轻易地猜出，\n请至少使用 8 个字符。"
"[english]SteamUI_WelcomeCreatingAccountEnterName"	"Please provide an account name and password.\nBe sure to make your password something hard\nto guess, and use at least 8 characters."
"SteamUI_WelcomeCreatingAccountAccountName"	"帐号名称"
"[english]SteamUI_WelcomeCreatingAccountAccountName"	"Account Name"
"SteamUI_WelcomeCreatingAccountPassword"	"密码"
"[english]SteamUI_WelcomeCreatingAccountPassword"	"Password"
"SteamUI_WelcomeCreatingAccountRetypePassword"	"再次输入密码"
"[english]SteamUI_WelcomeCreatingAccountRetypePassword"	"Retype password"
"Steam_PasswordStrength"	"密码强度："
"[english]Steam_PasswordStrength"	"Password strength:"
"SteamUI_AccountNameInfo"	"请输入您的电子邮件地址。如果您忘记了您的\n密码，您需要通过此地址来\n验证您的身份。"
"[english]SteamUI_AccountNameInfo"	"Please enter your email address. If you forget your\npassword, you will be contacted via this address to\nverify your identity."
"SteamUI_CreateAccount_ContactEmail"	"联系电子邮件地址"
"[english]SteamUI_CreateAccount_ContactEmail"	"Contact email address"
"SteamUI_CreateAccount_ContactEmailConfirm"	"确认电子邮件地址"
"[english]SteamUI_CreateAccount_ContactEmailConfirm"	"Confirm email address"
"WelcomeToSteamEmailLabel2"	"（必须是有效帐号）"
"[english]WelcomeToSteamEmailLabel2"	"(must be a valid account)"
"Steam_CreateNewAccount_CreateAccount"	"创建一个新的帐号"
"[english]Steam_CreateNewAccount_CreateAccount"	"Create new account"
"Steam_CreateNewAccount_FindOldAccount"	"找到我的旧帐号"
"[english]Steam_CreateNewAccount_FindOldAccount"	"Find my old account"
"Steam_CreateNewAccount_EmailAddrAlreadyInUse"	"具有该联系电子邮件地址的Dota 2帐号已经被使用。如果您以前创建过Dota 2帐号，您应当使用这个已经存在的帐号而不是创建新帐号。"
"[english]Steam_CreateNewAccount_EmailAddrAlreadyInUse"	"A Dota 2 account already exists with that contact email address. If you have previously created a Dota 2 account, you should use the existing account rather than creating a new one."
"Steam_CreateNewAccount_AccountsFAQ"	"Dota 2账号常见问题"
"[english]Steam_CreateNewAccount_AccountsFAQ"	"The Dota 2 Accounts FAQ"
"Steam_PleaseVisitSupportPage"	"要获得进一步的帮助或产品支持，请访问："
"[english]Steam_PleaseVisitSupportPage"	"For further help or product support, please visit:"
"SteamUI_SecretQuestionExplanation"	"作为附加的安全措施，请选择一个密保问题并在下面提供答案。当您遗忘了密码时这就派上用场了。"
"[english]SteamUI_SecretQuestionExplanation"	"As an additional security measure, please select a secret question and provide the answer below. This will be used if you ever forget your password."
"SteamUI_SecretQuestion"	"机密问题"
"[english]SteamUI_SecretQuestion"	"Secret question"
"SteamUI_Answer"	"接听"
"[english]SteamUI_Answer"	"Answer"
"WelcomeAccountCreateComplete"	"设置完毕！感谢您体验Dota 2。此程序在通知托盘区运行 -- 一般在您屏幕的右下角。要进入Dota 2，请右击其图标。"
"[english]WelcomeAccountCreateComplete"	"You're all set! Thanks for playing Dota 2. The program runs in the Notification Tray -- usually at the lower right of your screen. To access Dota 2, click on its icon."
"SteamUI_ForgottenPasswordEmailAddress"	"我记住了使用过的联系电子邮件地址。"
"[english]SteamUI_ForgottenPasswordEmailAddress"	"I remember the contact email address I used."
"SteamUI_ForgottenPasswordCDKey"	"我记得我所使用的产品代码。"
"[english]SteamUI_ForgottenPasswordCDKey"	"I remember the product code I used."
"SteamUI_ForgottenPasswordOther"	"我没有上述任何一项信息。"
"[english]SteamUI_ForgottenPasswordOther"	"I don't have either of these."
"SteamUI_ForgottenPasswordAccountName"	"要获取帐号名称，您需要提供在创建帐号时使用过的联系电子邮件地址，或提供向帐号注册的产品代码。"
"[english]SteamUI_ForgottenPasswordAccountName"	"To retrieve your account name you need either the contact email address you used when creating your account or the product code you registered to the account."
"Steam_CDKey"	"产品代码"
"[english]Steam_CDKey"	"Product code"
"SteamUI_ForgottenPasswordEnterCDKey"	"要获取帐号名称，请输入激活Dota 2帐号的产品代码。"
"[english]SteamUI_ForgottenPasswordEnterCDKey"	"To retrieve your account name please enter the product code you activated to your Dota 2 account."
"SteamUI_ForgottenPasswordEnterEmailAddr"	"请输入您注册Dota 2账户时使用的电子邮件地址。"
"[english]SteamUI_ForgottenPasswordEnterEmailAddr"	"Please enter the contact email address you used when you created your Dota 2 account."
"SteamUI_ForgottenPasswordOtherText"	"要获取帐号信息，您需要知道激活帐号时使用过的联系电子邮件地址或产品代码。"
"[english]SteamUI_ForgottenPasswordOtherText"	"To retrieve your account information you need to either know the contact email address or the product code you used when activating the account."
"Steam_ForgottenPassword_AskSecretQuestion"	"当您创建您的Dota 2帐号时，我们曾经\n询问过您一个只有您知道的密保问题。\n请输入这个问题的答案："
"[english]Steam_ForgottenPassword_AskSecretQuestion"	"When you created your Dota 2 account, we asked\nyou for an answer to a 'secret' question, which only\nyou would know. Please enter your answer below:"
"SteamUI_YourAnswer"	"您的答案"
"[english]SteamUI_YourAnswer"	"Your Answer"
"Steam_ForgottenPassword_Authorization"	"刚才已经按您提供的地址\n发送了一条包含验证代码和密保问题的\n电子邮件消息。请检查您的电子邮件，\n然后在下面输入请求的信息。"
"[english]Steam_ForgottenPassword_Authorization"	"An email message containing a verification code\nand a secret question has just been sent to the\naddress you provided. Please check your email,\nthen enter the requested information below."
"Steam_ForgottenPassword_VerificationCode"	"验证代码"
"[english]Steam_ForgottenPassword_VerificationCode"	"Verification code"
"Steam_ForgottenPassword_SecretAnswer"	"秘密答案"
"[english]Steam_ForgottenPassword_SecretAnswer"	"Secret answer"
"SteamUI_ForgottenPasswordResetPassword"	"我知道自己的帐号名称。"
"[english]SteamUI_ForgottenPasswordResetPassword"	"I know my account name."
"SteamUI_ForgottenPasswordGetAccountName"	"我不知道我的账号名。"
"[english]SteamUI_ForgottenPasswordGetAccountName"	"I don't know my account name."
"SteamUI_ForgottenPasswordResetType"	"要取回您Dota 2账号的登录信息，我们需要从您的账户名开始。"
"[english]SteamUI_ForgottenPasswordResetType"	"To retrieve the login information for your Dota 2 account, we need to start with your account name."
"Steam_NewPassword_Enter"	"请输入一个新密码。\n该密码长度必须有至少8位。"
"[english]Steam_NewPassword_Enter"	"Please enter a new password.\nIt must be at least 8 characters in length."
"Steam_NewPassword_Label"	"新密码"
"[english]Steam_NewPassword_Label"	"New password"
"Steam_NewPassword_Confirm"	"确认密码"
"[english]Steam_NewPassword_Confirm"	"Confirm password"
"Steam_ForgottenPassword_Success"	"您的密码已更改。\n\n请单击下面的‘结束’来返回登录界面。"
"[english]Steam_ForgottenPassword_Success"	"Your password has been changed.\n\nPlease click 'finish' below to return to the login screen."
"Steam_ForgottenPassword_VerifyIdentity"	"在我们修改您的密码之前，第一步是要确认您的身份。请输入您的帐号名称。"
"[english]Steam_ForgottenPassword_VerifyIdentity"	"Before we can change your password, we first need to verify your identity. Please enter your account name."
"Steam_AccountName"	"帐号名称"
"[english]Steam_AccountName"	"Account name"
"SteamUI_ForgottenPasswordSentEmailEmail"	"我们已经给您发送了一封包含您的Dota 2帐号名称的电子邮件。\n\n收到这封电子邮件之后，您可以立即点击“获取丢失的帐号”按钮来找回密码。"
"[english]SteamUI_ForgottenPasswordSentEmailEmail"	"An email containing your Dota 2 account name has been sent to you.\n\nOnce you receive the email, you can click the \"Retrieve lost account\" button again to reset your password."
"Steam_InOfflineModeButNeedToLogIn"	"无法连接到Dota 2网络。"
"[english]Steam_InOfflineModeButNeedToLogIn"	"Unable to connect to the Dota 2 network."
"Steam_CloudConflict_Newer"	"- 新上传云内容"
"[english]Steam_CloudConflict_Newer"	"- NEWER"
"Steam_CloudConflict_Older"	"- 原有云内容"
"[english]Steam_CloudConflict_Older"	"- OLDER"
"Steam_CloudConflict_Unknown"	"未知"
"[english]Steam_CloudConflict_Unknown"	"Unknown"
"Steam_CloudConflict_Title"	"Dota 2 - 云同步冲突"
"[english]Steam_CloudConflict_Title"	"Dota 2 - Cloud Sync Conflict"
"Steam_CloudConflict_Text"	"您的本地%game%文件与储存在Dota 2云端的文件冲突。"
"[english]Steam_CloudConflict_Text"	"Your local %game% files conflict with the ones stored in the Dota 2 Cloud."
"Steam_CloudConflict_CloudFiles"	"云端文件"
"[english]Steam_CloudConflict_CloudFiles"	"Cloud Files"
"Steam_CloudConflict_CloudFiles_Time"	"上次更改： %remotetime%"
"[english]Steam_CloudConflict_CloudFiles_Time"	"Last modified: %remotetime%"
"Steam_CloudConflict_LocalFiles"	"本地文件"
"[english]Steam_CloudConflict_LocalFiles"	"Local Files"
"Steam_CloudConflict_LocalFiles_Time"	"上次更改： %remotetime%"
"[english]Steam_CloudConflict_LocalFiles_Time"	"Last modified: %remotetime%"
"Steam_CloudConflict_Accept_Local"	"上传到Dota 2云"
"[english]Steam_CloudConflict_Accept_Local"	"Upload to the Dota 2 Cloud"
"Steam_CloudConflict_Accept_Remote"	"下载到本设备"
"[english]Steam_CloudConflict_Accept_Remote"	"Download to this machine"
"Steam_CloudConflict_Cancel"	"取消 - 暂不作任何复制"
"[english]Steam_CloudConflict_Cancel"	"Cancel - don't copy anything now"
"Steam_CloudConflict_Note"	"注意：要启动Dota 2您必须选择以上两个选项中的一项。"
"[english]Steam_CloudConflict_Note"	"NOTE: You'll have to choose one of the other two options above in order to launch Dota 2."
"SteamUI_JoinDialog_CloudSyncFailed_Title"	"Dota 2 - 警告"
"[english]SteamUI_JoinDialog_CloudSyncFailed_Title"	"Dota 2 - Warning"
"SteamUI_JoinDialog_PlayGame_Btn$apptype=game"	"开始 Dota 2"
"[english]SteamUI_JoinDialog_PlayGame_Btn$apptype=game"	"Play Dota 2"
"SteamUI_JoinDialog_CloudSyncFailed_Text"	"Dota 2 无法与您云端的Dota 2文件同步。"
"[english]SteamUI_JoinDialog_CloudSyncFailed_Text"	"Dota 2 was unable to sync your files with the Dota 2 Cloud"
"SteamUI_JoinDialog_CloudSyncFailed_Detail"	"如果您在另外一台电脑上启动了Dota 2， 您的更改可能和云端储存的不一致。如果您现在启动Dota 2，您可能会丢失这些改动。"
"[english]SteamUI_JoinDialog_CloudSyncFailed_Detail"	"If you have launched Dota 2 from another computer, your settings may not be in sync with what is stored in the Cloud. If you launch the Dota 2 now, you may lose those changes."
"D2L_AccountLabel"	"账号"
"[english]D2L_AccountLabel"	"Account"
"D2L_DownloadLabel"	"下载"
"[english]D2L_DownloadLabel"	"Download"
"D2L_InterfaceLabel"	"界面"
"[english]D2L_InterfaceLabel"	"Interface"
"SteamUI_SSA_Agree"	"请完整阅读本协议。您必须同意Dota 2用户协议中的条款后才能继续。"
"[english]SteamUI_SSA_Agree"	"Please read this agreement in its entirety. You must agree with the terms of the Dota 2 Subscriber Agreement to continue."
"Steam_Tooltip_Syncing"	"Dota 2 - 同步中"
"[english]Steam_Tooltip_Syncing"	"Dota 2 - synchronizing"
"Steam_Tooltip_Offline"	"Dota 2 - 离线"
"[english]Steam_Tooltip_Offline"	"Dota 2 - offline"
"Steam_Tooltip_Downloading"	"Dota 2 - 正以%s1/秒的速度下载"
"[english]Steam_Tooltip_Downloading"	"Dota 2 - downloading at %s1/s"
"Steam_Tooltip_Steam"	"Dota 2"
"[english]Steam_Tooltip_Steam"	"Dota 2"
"Steam_Login_Title"	"Dota 2 登录"
"[english]Steam_Login_Title"	"Dota 2 Login"
"Steam_SteamErrorTitle"	"Dota 2 - 错误"
"[english]Steam_SteamErrorTitle"	"Dota 2 - Error"
"Steam_PreparingGamesList"	"正在准备 Dota 2 游戏列表%progress%"
"[english]Steam_PreparingGamesList"	"Preparing Dota 2"
"Steam_ScanningForUpdates"	"正在扫描 Dota 2 游戏更新%progress%"
"[english]Steam_ScanningForUpdates"	"Scanning for Dota 2 updates%progress%"
"Steam_Uninstall_Games_Dialog_Title"	"Dota 2 - 卸载"
"[english]Steam_Uninstall_Games_Dialog_Title"	"Dota 2 - Uninstall"
"Steam_Shutdown_Dialog_Title"	"Dota 2 - 关闭"
"[english]Steam_Shutdown_Dialog_Title"	"Dota 2 - Shutdown"
"Steam_Shutdown_Dialog_Text"	"正在关闭 Dota 2 ..."
"[english]Steam_Shutdown_Dialog_Text"	"Shutting down Dota 2 ..."
"Steam_InstallComplete_RetailInstall"	"Dota 2 安装完毕。已开始在后台下载更新。"
"[english]Steam_InstallComplete_RetailInstall"	"Dota 2 is now accessible, any updates have begun downloading in the background."
"Steam_InstallComplete_RetailInstall_GamesAlwaysAvailable"	"您可以通过任意计算机，在任意时间再次安装并运行Dota 2，只需登陆您的Dota 2帐号 '%account%'。"
"[english]Steam_InstallComplete_RetailInstall_GamesAlwaysAvailable"	"You can access Dota 2 again at any time, from any computer, by logging into your Dota 2 account '%account%'."
"Steam_CancelInstall_Title"	"Dota 2 - 取消安装"
"[english]Steam_CancelInstall_Title"	"Dota 2 - Cancel install"
"Steam_PurchaseProgress_Title"	"Dota 2 - 运行中"
"[english]Steam_PurchaseProgress_Title"	"Dota 2 - Working"
"Steam_PurchaseProgress_Info"	"正通过 Dota 2 激活密钥..."
"[english]Steam_PurchaseProgress_Info"	"Activating key with Dota 2..."
"SteamUI_SSA_ActivateProduct"	"要在 Dota 2 上注册您的产品，请在此处输入零售 CD/DVD 上分配的产品代码或其它 Dota 2 产品序列号。 点击“下一步”以继续。"
"[english]SteamUI_SSA_ActivateProduct"	"To register your Dota 2, enter the product code distributed with a retail CD/DVD or other Dota 2 product key here. Click 'Next' to continue."
"Steam_InstallComplete_DownloadInfo"	"Dota 2 正在下载。"
"[english]Steam_InstallComplete_DownloadInfo"	"Dota 2 is now downloading. "
"Steam_SubscriptionSuccess_CDKey"	"您的产品代码已被成功激活。此产品现在已与您的 Dota 2 帐号永久关联。"
"[english]Steam_SubscriptionSuccess_CDKey"	"Your product activation code has successfully been activated. This product or products listed below are now permanently associated with your Dota 2 account."
"Steam_TroubleshooterLink"	""
"[english]Steam_TroubleshooterLink"	""
"Steam_TroubleshooterURL_CDKey"	""
"[english]Steam_TroubleshooterURL_CDKey"	""
"steam_checkforupdates_title"	"Dota 2启动器 - 自动更新器"
"[english]steam_checkforupdates_title"	"Dota 2 Launcher - Self Updater"
"steam_ClientUpdateAvailableDownloaded"	"Dota 2客户端的更新已下载完毕"
"[english]steam_ClientUpdateAvailableDownloaded"	"A Dota 2 Launcher update has been downloaded."
"steam_ClientUpdateAvailableDownloadedInfo"	"您想现在就重启Dota 2客户端来应用更新吗？"
"[english]steam_ClientUpdateAvailableDownloadedInfo"	"Would you like to restart Dota 2 Launcher now to apply the update?"
"steam_ClientUpdateAvailableDownloading"	"Dota 2客户端有一个更新可用，并正在下载。"
"[english]steam_ClientUpdateAvailableDownloading"	"A Dota 2 Launcher update is available, and is now being downloaded."
"Steam_CheckingForUpdates"	"检查更新中..."
"[english]Steam_CheckingForUpdates"	"Checking for updates..."
"Steam_NoClientUpdateAvailable"	"您的Dota 2客户端已经是最新的了。"
"[english]Steam_NoClientUpdateAvailable"	"Your Dota 2 Launcher is already up-to-date."
"Steam_MustRestart_Button"	"重启Dota 2客户端"
"[english]Steam_MustRestart_Button"	"Restart Dota 2 Launcher"
"Steam_ChangeContactEmailWizardAbout"	"您的电子邮件地址用于确认购买并帮助您管理对 Dota 2 帐号的访问。"
"[english]Steam_ChangeContactEmailWizardAbout"	"Your email address is used to help you manage access to your Dota 2 account."
"Steam_GameLaunchOptions_Title"	"%game%"
"[english]Steam_GameLaunchOptions_Title"	"%game%"
"SteamUI_JoinDialog_Title"	"%game%"
"[english]SteamUI_JoinDialog_Title"	"%game%"
"D2L_Dota2ChineseName" "刀塔"
"[english]D2L_Dota2ChineseName" ""
}
}