"tenfoot"
{
"UI_Submit"	"Wyślij"
"[english]UI_Submit"	"Submit"
"UI_Select"	"Wybierz"
"[english]UI_Select"	"Select"
"UI_Inspect"	"Zbadaj"
"[english]UI_Inspect"	"Inspect"
"UI_LeftStick_Short"	"LS"
"[english]UI_LeftStick_Short"	"LS"
"UI_RightStick_Short"	"RS"
"[english]UI_RightStick_Short"	"RS"
"UI_LeftTrigger_Short"	"LT"
"[english]UI_LeftTrigger_Short"	"LT"
"UI_RightTrigger_Short"	"RT"
"[english]UI_RightTrigger_Short"	"RT"
"UI_LeftBumper_Short"	"LB"
"[english]UI_LeftBumper_Short"	"LB"
"UI_RightBumper_Short"	"RB"
"[english]UI_RightBumper_Short"	"RB"
"UI_AButton"	"A"
"[english]UI_AButton"	"A"
"UI_BButton"	"B"
"[english]UI_BButton"	"B"
"UI_XButton"	"X"
"[english]UI_XButton"	"X"
"UI_YButton"	"Y"
"[english]UI_YButton"	"Y"
"UI_Cancel"	"ANULUJ"
"[english]UI_Cancel"	"CANCEL"
"UI_OK"	"OK"
"[english]UI_OK"	"OK"
"UI_Backspace"	"BACKSPACE"
"[english]UI_Backspace"	"BACKSPACE"
"UI_Spacebar"	"SPACJA"
"[english]UI_Spacebar"	"SPACE"
"UI_MoveCaret"	"RUCH KURSOREM"
"[english]UI_MoveCaret"	"MOVE CURSOR"
"UI_MoveCaretLeft"	"« KURSOR"
"[english]UI_MoveCaretLeft"	"« CURSOR"
"UI_MoveCaretRight"	"KURSOR »"
"[english]UI_MoveCaretRight"	"CURSOR »"
"UI_InputDone"	"GOTOWE"
"[english]UI_InputDone"	"DONE"
"UI_MoreOptions"	"WIĘCEJ OPCJI"
"[english]UI_MoreOptions"	"MORE OPTIONS"
"UI_SendMessage"	"WYŚLIJ"
"[english]UI_SendMessage"	"SEND"
"UI_Languages"	"JĘZYKI"
"[english]UI_Languages"	"LANGUAGES"
"UI_Today"	"Dzisiaj"
"[english]UI_Today"	"Today"
"UI_Yesterday"	"Wczoraj"
"[english]UI_Yesterday"	"Yesterday"
"UI_Tomorrow"	"Jutro"
"[english]UI_Tomorrow"	"Tomorrow"
"UI_Hours"	"godz."
"[english]UI_Hours"	"hours"
"UI_Minutes"	"min"
"[english]UI_Minutes"	"minutes"
"UI_Seconds"	"s"
"[english]UI_Seconds"	"seconds"
"UI_Hour"	"godz."
"[english]UI_Hour"	"hour"
"UI_Minute"	"minuta"
"[english]UI_Minute"	"minute"
"UI_Second"	"sekunda"
"[english]UI_Second"	"second"
"UI_UnknownTime"	"Nieznany"
"[english]UI_UnknownTime"	"Unknown"
"Panorama_Lang_English"	"angielski"
"[english]Panorama_Lang_English"	"English"
"Panorama_Lang_Spanish"	"hiszpański"
"[english]Panorama_Lang_Spanish"	"Spanish"
"Panorama_Lang_French"	"francuski"
"[english]Panorama_Lang_French"	"French"
"Panorama_Lang_Italian"	"włoski"
"[english]Panorama_Lang_Italian"	"Italian"
"Panorama_Lang_German"	"niemiecki"
"[english]Panorama_Lang_German"	"German"
"Panorama_Lang_Greek"	"grecki"
"[english]Panorama_Lang_Greek"	"Greek"
"Panorama_Lang_Korean"	"koreański"
"[english]Panorama_Lang_Korean"	"Korean"
"Panorama_Lang_Simplified_Chinese"	"chiński uproszczony"
"[english]Panorama_Lang_Simplified_Chinese"	"Simplified Chinese"
"Panorama_Lang_Traditional_Chinese"	"chiński tradycyjny"
"[english]Panorama_Lang_Traditional_Chinese"	"Traditional Chinese"
"Panorama_Lang_Russian"	"rosyjski"
"[english]Panorama_Lang_Russian"	"Russian"
"Panorama_Lang_Thai"	"tajski"
"[english]Panorama_Lang_Thai"	"Thai"
"Panorama_Lang_Japanese"	"japoński"
"[english]Panorama_Lang_Japanese"	"Japanese"
"Panorama_Lang_Portuguese"	"portugalski"
"[english]Panorama_Lang_Portuguese"	"Portuguese"
"Panorama_Lang_Brazilian"	"portugalski brazylijski"
"[english]Panorama_Lang_Brazilian"	"Portuguese-Brazil"
"Panorama_Lang_Polish"	"polski"
"[english]Panorama_Lang_Polish"	"Polish"
"Panorama_Lang_Danish"	"duński"
"[english]Panorama_Lang_Danish"	"Danish"
"Panorama_Lang_Dutch"	"holenderski"
"[english]Panorama_Lang_Dutch"	"Dutch"
"Panorama_Lang_Finnish"	"fiński"
"[english]Panorama_Lang_Finnish"	"Finnish"
"Panorama_Lang_Norwegian"	"norweski"
"[english]Panorama_Lang_Norwegian"	"Norwegian"
"Panorama_Lang_Swedish"	"szwedzki"
"[english]Panorama_Lang_Swedish"	"Swedish"
"Panorama_Lang_Czech"	"czeski"
"[english]Panorama_Lang_Czech"	"Czech"
"Panorama_Lang_Hungarian"	"węgierski"
"[english]Panorama_Lang_Hungarian"	"Hungarian"
"Panorama_Lang_Romanian"	"rumuński"
"[english]Panorama_Lang_Romanian"	"Romanian"
"Panorama_Lang_Bulgarian"	"bułgarski"
"[english]Panorama_Lang_Bulgarian"	"Bulgarian"
"Panorama_Lang_Turkish"	"turecki"
"[english]Panorama_Lang_Turkish"	"Turkish"
"Panorama_Lang_Footer_English"	"ANGIELSKI"
"[english]Panorama_Lang_Footer_English"	"ENGLISH"
"Panorama_Lang_Footer_Spanish"	"HISZPAŃSKI"
"[english]Panorama_Lang_Footer_Spanish"	"SPANISH"
"Panorama_Lang_Footer_French"	"FRANCUSKI"
"[english]Panorama_Lang_Footer_French"	"FRENCH"
"Panorama_Lang_Footer_Italian"	"WŁOSKI"
"[english]Panorama_Lang_Footer_Italian"	"ITALIAN"
"Panorama_Lang_Footer_German"	"NIEMIECKI"
"[english]Panorama_Lang_Footer_German"	"GERMAN"
"Panorama_Lang_Footer_Greek"	"GRECKI"
"[english]Panorama_Lang_Footer_Greek"	"GREEK"
"Panorama_Lang_Footer_Korean"	"KOREAŃSKI"
"[english]Panorama_Lang_Footer_Korean"	"KOREAN"
"Panorama_Lang_Footer_Simplified_Chinese"	"CHIŃSKI UPR."
"[english]Panorama_Lang_Footer_Simplified_Chinese"	"SIM CHINESE"
"Panorama_Lang_Footer_Traditional_Chinese"	"CHIŃSKI TRAD."
"[english]Panorama_Lang_Footer_Traditional_Chinese"	"TRAD CHINESE"
"Panorama_Lang_Footer_Russian"	"ROSYJSKI"
"[english]Panorama_Lang_Footer_Russian"	"RUSSIAN"
"Panorama_Lang_Footer_Thai"	"TAJSKI"
"[english]Panorama_Lang_Footer_Thai"	"THAI"
"Panorama_Lang_Footer_Japanese"	"JAPOŃSKI"
"[english]Panorama_Lang_Footer_Japanese"	"JAPANESE"
"Panorama_Lang_Footer_Portuguese"	"PORTUGALSKI"
"[english]Panorama_Lang_Footer_Portuguese"	"PORTUGUESE"
"Panorama_Lang_Footer_Brazilian"	"PORTUGALSKI-BR."
"[english]Panorama_Lang_Footer_Brazilian"	"PORTUGUESE-B"
"Panorama_Lang_Footer_Polish"	"POLSKI"
"[english]Panorama_Lang_Footer_Polish"	"POLISH"
"Panorama_Lang_Footer_Danish"	"DUŃSKI"
"[english]Panorama_Lang_Footer_Danish"	"DANISH"
"Panorama_Lang_Footer_Dutch"	"HOLENDERSKI"
"[english]Panorama_Lang_Footer_Dutch"	"DUTCH"
"Panorama_Lang_Footer_Finnish"	"FIŃSKI"
"[english]Panorama_Lang_Footer_Finnish"	"FINNISH"
"Panorama_Lang_Footer_Norwegian"	"NORWESKI"
"[english]Panorama_Lang_Footer_Norwegian"	"NORWEGIAN"
"Panorama_Lang_Footer_Swedish"	"SZWEDZKI"
"[english]Panorama_Lang_Footer_Swedish"	"SWEDISH"
"Panorama_Lang_Footer_Czech"	"CZESKI"
"[english]Panorama_Lang_Footer_Czech"	"CZECH"
"Panorama_Lang_Footer_Hungarian"	"WĘGIERSKI"
"[english]Panorama_Lang_Footer_Hungarian"	"HUNGARIAN"
"Panorama_Lang_Footer_Romanian"	"RUMUŃSKI"
"[english]Panorama_Lang_Footer_Romanian"	"ROMANIAN"
"Panorama_Lang_Footer_Bulgarian"	"BUŁGARSKI"
"[english]Panorama_Lang_Footer_Bulgarian"	"BULGARIAN"
"Panorama_Lang_Footer_Turkish"	"TURECKI"
"[english]Panorama_Lang_Footer_Turkish"	"TURKISH"
"MainMenu_Settings"	"USTAWIENIA"
"[english]MainMenu_Settings"	"SETTINGS"
"MainMenu_Exit"	"WYJŚCIE"
"[english]MainMenu_Exit"	"EXIT"
"MainMenu_Library"	"BIBLIOTEKA"
"[english]MainMenu_Library"	"LIBRARY"
"MainMenu_Web"	"SIEĆ"
"[english]MainMenu_Web"	"WEB"
"MainMenu_Select"	"WYBIERZ"
"[english]MainMenu_Select"	"SELECT"
"MainMenu_Back"	"WSTECZ"
"[english]MainMenu_Back"	"BACK"
"MainMenu_Friends"	"ZNAJOMI"
"[english]MainMenu_Friends"	"FRIENDS"
"MainMenu_Primary"	"STEAM"
"[english]MainMenu_Primary"	"STEAM"
"MainMenu_Store"	"SKLEP"
"[english]MainMenu_Store"	"STORE"
"MainMenu_Community"	"SPOŁECZNOŚĆ"
"[english]MainMenu_Community"	"COMMUNITY"
"MainMenu_Main"	"GŁÓWNA"
"[english]MainMenu_Main"	"MAIN"
"MainMenu_ActiveDownloadsShort"	"{d:downloads}"
"[english]MainMenu_ActiveDownloadsShort"	"{d:downloads}"
"MainMenu_ActiveDownloadsLong"	"POBIERANE: {d:downloads}"
"[english]MainMenu_ActiveDownloadsLong"	"{d:downloads} DOWNLOAD"
"MainMenu_ActiveDownloadsLongPlural"	"POBIERANE: {d:downloads}"
"[english]MainMenu_ActiveDownloadsLongPlural"	"{d:downloads} DOWNLOADS"
"MainMenu_ActivePausesLong"	"ELEMENTY ZATRZYMANE: {d:paused}"
"[english]MainMenu_ActivePausesLong"	"{d:paused} PAUSED"
"MainMenu_SystemIMsShort"	"NOWOŚCI: {d:systemims}"
"[english]MainMenu_SystemIMsShort"	"{d:systemims} NEW"
"MainMenu_SystemIMsLong"	"NOWOŚCI: {d:systemims}"
"[english]MainMenu_SystemIMsLong"	"{d:systemims} NEW FOR YOU"
"MainMenu_PersonaName"	"Witaj, {s:personaname}!"
"[english]MainMenu_PersonaName"	"Welcome {s:personaname}"
"MainMenu_Time"	"{t:T:curtime}"
"[english]MainMenu_Time"	"{t:T:curtime}"
"MainMenu_NewForYouTitle"	"NOWOŚCI"
"[english]MainMenu_NewForYouTitle"	"NEW FOR YOU"
"Test_MainLabel"	"Steam 10'\nTEKST..................!"
"[english]Test_MainLabel"	"Steam 10'\nTEXT..................!"
"Settings_Title"	"Ustawienia"
"[english]Settings_Title"	"Settings"
"Settings_Account"	"Konto"
"[english]Settings_Account"	"Account"
"Settings_Friends"	"Znajomi"
"[english]Settings_Friends"	"Friends"
"Settings_Languages"	"Języki i wpisywanie tekstu"
"[english]Settings_Languages"	"Languages & Text Entry"
"Settings_Audio"	"Dźwięk"
"[english]Settings_Audio"	"Audio"
"Settings_Display"	"Obraz"
"[english]Settings_Display"	"Display"
"Settings_Controller"	"Kontroler"
"[english]Settings_Controller"	"Controller"
"Settings_Voice"	"Głos"
"[english]Settings_Voice"	"Voice"
"Settings_InGame"	"W grze"
"[english]Settings_InGame"	"In-Game"
"Settings_Cloud"	"Pobieranie i Cloud"
"[english]Settings_Cloud"	"Downloads & Cloud"
"Settings_Select"	"WYBIERZ"
"[english]Settings_Select"	"SELECT"
"Settings_Back"	"WSTECZ"
"[english]Settings_Back"	"BACK"
"Settings_Done"	"GOTOWE"
"[english]Settings_Done"	"DONE"
"SettingsAccount_History"	"Wyświetl historię konta"
"[english]SettingsAccount_History"	"View account history"
"SettingsAccount_Verify"	"Zweryfikuj adres e-mail"
"[english]SettingsAccount_Verify"	"Verify email address"
"SettingsAccount_ChangePassword"	"Zmień hasło lub tajne pytanie"
"[english]SettingsAccount_ChangePassword"	"Change password or secret question"
"SettingsAccount_ChangeEmail"	"Zmień kontaktowy adres e-mail..."
"[english]SettingsAccount_ChangeEmail"	"Change contact email address"
"SettingsAccount_Beta"	"Udział w testach beta"
"[english]SettingsAccount_Beta"	"Beta participation"
"SettingsAccount_Changes"	"Zmiany wymagają ponownego uruchomienia Steam"
"[english]SettingsAccount_Changes"	"Changes require Steam to restart"
"SettingsAccount_SaveCredentials"	"Zapisz moje dane konta"
"[english]SettingsAccount_SaveCredentials"	"Save my account credentials"
"SettingsAccount_MustSave"	"Dane konta muszą zostać zapisane, aby uruchomić tryb offline"
"[english]SettingsAccount_MustSave"	"Credentials must be saved to use Offline Mode"
"SettingsAccount_AccountName"	"Nazwa konta"
"[english]SettingsAccount_AccountName"	"Account name"
"SettingsAccount_AccountNameText"	"{s:accountname}"
"[english]SettingsAccount_AccountNameText"	"{s:accountname}"
"SettingsAccount_VacStatus"	"Status VAC"
"[english]SettingsAccount_VacStatus"	"VAC status"
"SettingsAccount_SecurityStatus"	"Poziom zabezpieczeń"
"[english]SettingsAccount_SecurityStatus"	"Security status"
"SettingsAccount_ContactEmail"	"E-mail kontaktowy"
"[english]SettingsAccount_ContactEmail"	"Contact email"
"SettingsAccount_ContactEmailText"	"{s:contactemail}"
"[english]SettingsAccount_ContactEmailText"	"{s:contactemail}"
"SettingsAccount_EmailStatus"	"Status adresu e-mail"
"[english]SettingsAccount_EmailStatus"	"Email status"
"SettingsAccount_EmailStatusVerified"	"Zweryfikowany"
"[english]SettingsAccount_EmailStatusVerified"	"Verified"
"SettingsAccount_EmailStatusUnverified"	"Niezweryfikowany"
"[english]SettingsAccount_EmailStatusUnverified"	"Not yet verified"
"SettingsAccount_SteamGuardStatus"	"Status Steam Guard"
"[english]SettingsAccount_SteamGuardStatus"	"Steam Guard status"
"SettingsAccount_SteamGuardUnverified"	"Adres e-mail nie został jeszcze zweryfikowany"
"[english]SettingsAccount_SteamGuardUnverified"	"Email address not yet verified"
"SettingsAccount_SteamGuardProtected"	"Chroniony przez Steam Guard"
"[english]SettingsAccount_SteamGuardProtected"	"Protected by Steam Guard"
"SettingsAccount_SteamGuardDisabled"	"Steam Guard wyłączony"
"[english]SettingsAccount_SteamGuardDisabled"	"Steam Guard disabled"
"SettingsAccount_SteamGuardOffline"	"Nieznany, offline"
"[english]SettingsAccount_SteamGuardOffline"	"Unknown, offline"
"SettingsAccount_BetaParticipation"	"Udział w testach beta"
"[english]SettingsAccount_BetaParticipation"	"Beta participation"
"SettingsAccount_NoBetaAvailable"	"(aktualnie brak testów)"
"[english]SettingsAccount_NoBetaAvailable"	"(None currently available)"
"SettingsAccount_NoBetaChosen"	"Brak (aktualnie dostępnych: {i:numbetas})"
"[english]SettingsAccount_NoBetaChosen"	"Not participating ({i:numbetas} currently available)"
"SettingsAccount_NoBetaChosenNonAdmin"	"Aktualnie dostępnych: {i:numbetas} (Tylko użytkownicy, którzy zainstalowali Steam, mogą zmienić stan udziału w wersji Beta)"
"[english]SettingsAccount_NoBetaChosenNonAdmin"	"{i:numbetas} currently available (Only the user who installed Steam can change Beta participation.)"
"SettingsAccount_InBeta"	"{s:electedbeta}"
"[english]SettingsAccount_InBeta"	"{s:electedbeta}"
"SettingsAccount_UserCantSetBeta"	"{s:electedbeta} (Tylko użytkownicy, którzy zainstalowali Steam, mogą zmienić stan udziału w wersji Beta)"
"[english]SettingsAccount_UserCantSetBeta"	"{s:electedbeta} (Only the user who installed Steam can change Beta participation.)"
"VAC_NoBans"	"W dobrym stanie"
"[english]VAC_NoBans"	"In good standing"
"VAC_BannedFromServers"	"Zablokowany na bezpiecznych serwerach z powodu oszustwa."
"[english]VAC_BannedFromServers"	"Banned from some secure servers because of a cheating infraction."
"SettingsFriends_Avatar"	"Awatar i nazwa profilu"
"[english]SettingsFriends_Avatar"	"Avatar and profile name"
"SettingsFriends_ChangeAvatar"	"Zmień mój awatar"
"[english]SettingsFriends_ChangeAvatar"	"Change my avatar"
"SettingsFriends_ViewProfile"	"Wyświetl mój profil Społeczności Steam"
"[english]SettingsFriends_ViewProfile"	"View my Steam Community profile"
"SettingsFriends_AutoSignIn"	"Automatycznie zaloguj do Znajomych"
"[english]SettingsFriends_AutoSignIn"	"Automatically sign into Friends"
"SettingsFriends_Timestamps"	"Wyświetlaj czas w oknie czatu"
"[english]SettingsFriends_Timestamps"	"Display timestamps in chat"
"SettingsFriends_WhenReceived"	"Gdy otrzymam wiadomość"
"[english]SettingsFriends_WhenReceived"	"When I receive a message"
"SettingsFriends_WhenFriendJoins"	"Gdy znajomy dołączy do gry"
"[english]SettingsFriends_WhenFriendJoins"	"When a friend joins a game"
"SettingsFriends_WhenFriendOnline"	"Gdy znajomy przechodzi w stan online"
"[english]SettingsFriends_WhenFriendOnline"	"When a friend comes online"
"SettingsFriends_PlaySound"	"Odtwórz dźwięk"
"[english]SettingsFriends_PlaySound"	"Play a sound"
"SettingsFriends_DisplayNotification"	"Wyświetl powiadomienie"
"[english]SettingsFriends_DisplayNotification"	"Display a notification"
"SettingsFriends_SetPersonaName"	"Ustaw nazwę profilu"
"[english]SettingsFriends_SetPersonaName"	"Set profile name"
"SettingsDisplay_Intro_old"	"Tryb Big Picture może działać w rozdzielczości 720p lub 1080p. Wybierz odpowiednią z listy poniżej."
"[english]SettingsDisplay_Intro_old"	"Big Picture mode can run in 720p or 1080p. Choose a video setting below."
"SettingsDisplay_Restart"	"Zmiany rozdzielczości zostaną zastosowane po ponownym uruchomieniu trybu Big Picture."
"[english]SettingsDisplay_Restart"	"Resolution changes will take effect the next time you enter Big Picture mode."
"SettingsDisplay_Resolution"	"Rozdzielczość docelowa"
"[english]SettingsDisplay_Resolution"	"Target Resolution"
"SettingsDisplay_1080p"	"1920x1080 (1080p)"
"[english]SettingsDisplay_1080p"	"1920x1080 (1080p)"
"SettingsDisplay_720p"	"1280x720 (720p)"
"[english]SettingsDisplay_720p"	"1280x720 (720p)"
"SettingsInGame_Intro"	"Steam może pozostać aktywny i dostępny z poziomu samych gier"
"[english]SettingsInGame_Intro"	"Steam can remain active and accessible from within your games"
"SettingsInGame_Enable"	"Włącz nakładkę Steam"
"[english]SettingsInGame_Enable"	"Enable the Steam Overlay"
"SettingsInGame_Overlay"	"Nakładka"
"[english]SettingsInGame_Overlay"	"Overlay"
"SettingsInGame_ShortcutKey"	"Skrót klawiszowy"
"[english]SettingsInGame_ShortcutKey"	"Keyboard shortcut"
"SettingsInGame_ShortcutBtn"	"Skrót na kontrolerze"
"[english]SettingsInGame_ShortcutBtn"	"Controller shortcut"
"SettingsInGame_Screenshots"	"Zrzut ekranu"
"[english]SettingsInGame_Screenshots"	"Screenshot"
"SettingsInGame_WhenScreenshotTaken"	"Po wykonaniu zrzutu ekranu"
"[english]SettingsInGame_WhenScreenshotTaken"	"When I take a screenshot"
"SettingsInGame_DisplayNotification"	"Wyświetl powiadomienie"
"[english]SettingsInGame_DisplayNotification"	"Display a notification"
"SettingsInGame_PlaySound"	"Odtwórz dźwięk"
"[english]SettingsInGame_PlaySound"	"Play a sound"
"SettingsInGame_Home"	"Przycisk strony głównej"
"[english]SettingsInGame_Home"	"Home Button"
"SettingsInGame_Home_NoEdit"	"Przycisk strony głównej (stały)"
"[english]SettingsInGame_Home_NoEdit"	"Home Button (fixed)"
"SettingsVoice_WhenActive"	"Gdy czat głosowy jest aktywny"
"[english]SettingsVoice_WhenActive"	"When voice chat is active"
"SettingsVoice_AutoXmit"	"Automatycznie przesyłaj głos, gdy mówię"
"[english]SettingsVoice_AutoXmit"	"Auto-transmit my voice"
"SettingsVoice_PTT"	"Przesyłaj głos po naciśnięciu przycisku „naciśnij i mów”"
"[english]SettingsVoice_PTT"	"Transmit with a push-to-talk key"
"SettingsVoice_Keyboard"	"Skrót klawiszowy"
"[english]SettingsVoice_Keyboard"	"Keyboard shortcut"
"SettingsVoice_Controller"	"Skrót na kontrolerze"
"[english]SettingsVoice_Controller"	"Controller shortcut"
"SettingsVoice_Bind_None"	"Nieprzypisany"
"[english]SettingsVoice_Bind_None"	"None set"
"SettingsVoice_TestMicrophone"	"Test mikrofonu"
"[english]SettingsVoice_TestMicrophone"	"Test microphone"
"SettingsVoice_EndTestMicrophone"	"Zakończ test"
"[english]SettingsVoice_EndTestMicrophone"	"End test"
"SettingsVoice_Boost"	"Zwiększ czułość"
"[english]SettingsVoice_Boost"	"Boost gain"
"SettingsVoice_MicVolume"	"Poziom głośności mikrofonu"
"[english]SettingsVoice_MicVolume"	"Microphone volume"
"SettingsVoice_RecvVolume"	"Poziom głośności odbiornika"
"[english]SettingsVoice_RecvVolume"	"Receive volume"
"SettingsVoice_DetectDevices"	"Wykryj urządzenia audio"
"[english]SettingsVoice_DetectDevices"	"Detect audio devices"
"SettingsVoice_InputDevice"	"Urządzenie wejściowe"
"[english]SettingsVoice_InputDevice"	"Input device"
"SettingsVoice_Microphone"	"{s:microphone}"
"[english]SettingsVoice_Microphone"	"{s:microphone}"
"SettingsVoice_NoneDetected"	"(Nie wykryto)"
"[english]SettingsVoice_NoneDetected"	"(None detected)"
"Debugger_Style"	"Styl"
"[english]Debugger_Style"	"Style"
"Debugger_Computed"	"Obliczone"
"[english]Debugger_Computed"	"Computed"
"Debugger_Measurements"	"Wymiary:"
"[english]Debugger_Measurements"	"Measurements:"
"Debugger_Misc"	"Różne:"
"[english]Debugger_Misc"	"Misc:"
"Debugger_Properties"	"Właściwości:"
"[english]Debugger_Properties"	"Properties:"
"Debugger_StyleFileLink"	"{s:stylefile}"
"[english]Debugger_StyleFileLink"	"{s:stylefile}"
"Debugger_LayoutFileLink"	"{s:layoutfile}"
"[english]Debugger_LayoutFileLink"	"{s:layoutfile}"
"Debugger_LayoutFileLink_Code"	"Z kodu"
"[english]Debugger_LayoutFileLink_Code"	"From Code"
"Debugger_InheritedStyleHeader"	"Dziedziczony z"
"[english]Debugger_InheritedStyleHeader"	"Inherited from "
"Debugger_Save"	"Zapisz wszystkie zmiany"
"[english]Debugger_Save"	"Save All Changes"
"Debugger_Revert"	"Cofnij wszystkie zmiany"
"[english]Debugger_Revert"	"Revert All Changes"
"Debugger_PanelStyleInvalid"	"Style zmieniają się podczas edycji! Wciśnij F5, aby przeładować wyświetlany styl"
"[english]Debugger_PanelStyleInvalid"	"Styles changed while editing! Hit F5 to reload displayed styles"
"Debugger_AnimationHeader"	"Klatki kluczowe animacji"
"[english]Debugger_AnimationHeader"	"Animation Keyframes"
"Debugger_DevInfo"	"Pokaż informacje deweloperskie"
"[english]Debugger_DevInfo"	"Show Dev Info"
"Store_Cart"	"KOSZYK"
"[english]Store_Cart"	"CART"
"Store_Search"	"SZUKAJ"
"[english]Store_Search"	"SEARCH"
"Store_AppName"	"{s:appname}"
"[english]Store_AppName"	"{s:appname}"
"Store_AvailableNow"	"Już dostępne"
"[english]Store_AvailableNow"	"Available Now"
"Store_AvailableNowPackage"	"Już dostępne i zawiera następującą zawartość"
"[english]Store_AvailableNowPackage"	"Available Now and includes the following"
"Store_ComingSoon"	"Wkrótce"
"[english]Store_ComingSoon"	"Coming Soon"
"Store_ComingSoon_Date"	"Wkrótce - {s:release_date}"
"[english]Store_ComingSoon_Date"	"Coming Soon - {s:release_date}"
"Store_Purchase"	"KUP"
"[english]Store_Purchase"	"PURCHASE"
"Store_Description"	"OPIS"
"[english]Store_Description"	"DESCRIPTION"
"Store_DescriptionOverview"	"Opis i cechy"
"[english]Store_DescriptionOverview"	"Story & Features"
"Store_DescriptionReadFull"	"Czytaj pełen opis"
"[english]Store_DescriptionReadFull"	"Read Full Description"
"Store_Details"	"SZCZEGÓŁY"
"[english]Store_Details"	"DETAILS"
"Store_Reviews"	"RECENZJE"
"[english]Store_Reviews"	"REVIEWS"
"Store_ReviewsOverview"	"Wynik + recenzje"
"[english]Store_ReviewsOverview"	"Score + Reviews"
"Store_ViewSystemRequirements"	"Zobacz wymagania systemowe"
"[english]Store_ViewSystemRequirements"	"View System Requirements"
"Store_SupportedLanguages"	"Wspierane języki"
"[english]Store_SupportedLanguages"	"Supported Languages"
"Store_ViewLegal"	"Przeczytaj uwagi o DRM i prawne"
"[english]Store_ViewLegal"	"Read Legal and DRM Notices"
"Store_Genres"	"Gatunek"
"[english]Store_Genres"	"Genre"
"Store_Metacritic"	"Metacritic"
"[english]Store_Metacritic"	"Metacritic"
"Store_MetacriticScore"	"{i:metacritic_score}"
"[english]Store_MetacriticScore"	"{i:metacritic_score}"
"Store_MetacriticScorePossible"	"/100"
"[english]Store_MetacriticScorePossible"	"/100"
"Store_ErrorWhileLoadingApp"	"Nie udało się uzyskać danych na temat tej pozycji. Spróbuj ponownie."
"[english]Store_ErrorWhileLoadingApp"	"Steam was unable to retrieve data for this title. Please try again."
"Store_ScreenshotDescription"	"Zrzuty ekranu: {s:appname}"
"[english]Store_ScreenshotDescription"	"{s:appname} Screenshots"
"Store_SlideshowDescription"	"{s:item_name}"
"[english]Store_SlideshowDescription"	"{s:item_name}"
"Store_GenreTitle"	"Gatunki"
"[english]Store_GenreTitle"	"Genres"
"Store_FullAppDescriptionTitle"	"Opis"
"[english]Store_FullAppDescriptionTitle"	"Description"
"Store_SystemRequirementsTitle"	"Wymagania systemowe"
"[english]Store_SystemRequirementsTitle"	"System Requirements"
"Store_PCRequirementsHeader"	"<span class=\"Header\">Wymagania dla PC</span>"
"[english]Store_PCRequirementsHeader"	"<span class=\"Header\">PC Requirements</span>"
"Store_MacRequirementsHeader"	"<span class=\"Header\">Wymagania dla Maców</span>"
"[english]Store_MacRequirementsHeader"	"<span class=\"Header\">Mac Requirements</span>"
"Store_Minimum"	"<strong>Minimalne</strong>"
"[english]Store_Minimum"	"<strong>Minimum</strong>"
"Store_Recommended"	"<strong>Zalecane</strong>"
"[english]Store_Recommended"	"<strong>Recommended</strong>"
"Store_FullLegalTitle"	"Informacje prawne oraz cyfrowe zarządzanie prawami"
"[english]Store_FullLegalTitle"	"Legal and Digital Rights Management"
"Store_DRMHeader"	"<span class=\"Header\">Informacja o DRM</span><br>"
"[english]Store_DRMHeader"	"<span class=\"Header\">DRM Notice</span><br>"
"Store_LegalHeader"	"<span class=\"Header\">Informacja prawna</span><br>"
"[english]Store_LegalHeader"	"<span class=\"Header\">Legal Notice</span><br>"
"Store_Platform_Windows"	"Windows"
"[english]Store_Platform_Windows"	"Windows"
"Store_Platform_Mac"	"Mac"
"[english]Store_Platform_Mac"	"Mac"
"Store_Category_Controller"	"Obsługa kontrolerów gier"
"[english]Store_Category_Controller"	"Controller Enabled"
"Store_Category_Achievements"	"Osiągnięcia"
"[english]Store_Category_Achievements"	"Achievements"
"Store_Category_Cloud"	"Steam Cloud"
"[english]Store_Category_Cloud"	"Steam Cloud"
"Store_Category_Singleplayer"	"Tryb jednoosobowy"
"[english]Store_Category_Singleplayer"	"Singleplayer"
"Store_Category_Multiplayer"	"Gra wieloosobowa"
"[english]Store_Category_Multiplayer"	"Multiplayer"
"Store_Category_Coop"	"Kooperacja"
"[english]Store_Category_Coop"	"Co-op"
"Store_Category_Leaderboards"	"Rankingi"
"[english]Store_Category_Leaderboards"	"Leaderboards"
"Store_Friends"	"SPOŁECZNOŚĆ"
"[english]Store_Friends"	"COMMUNITY"
"Store_AchievementsGame"	"Osiągnięcia: {i:achievements_game_count}"
"[english]Store_AchievementsGame"	"{i:achievements_game_count} Achievements"
"Store_FriendsPlayGame"	"{i:friend_play_count} znajomych posiada tę grę"
"[english]Store_FriendsPlayGame"	"{i:friend_play_count} Friends own this game"
"Store_FriendPlaysGame"	"{i:friend_play_count} znajomy posiada tę grę"
"[english]Store_FriendPlaysGame"	"{i:friend_play_count} Friend owns this game"
"Store_FriendsWantGame"	"{i:friend_want_count} znajomych chce tej gry"
"[english]Store_FriendsWantGame"	"{i:friend_want_count} Friends want this game"
"Store_FriendWantsGame"	"{i:friend_want_count} znajomy chce tej gry"
"[english]Store_FriendWantsGame"	"{i:friend_want_count} Friend wants this game"
"Store_FriendRecommended"	"Polecane przez znajomych  ({i:friend_recommend_count})"
"[english]Store_FriendRecommended"	"Recommended by Friends ({i:friend_recommend_count})"
"Store_FriendCommunityGroups"	"Znajdź grupy społeczności"
"[english]Store_FriendCommunityGroups"	"Find Community Groups"
"Store_FriendVisitForums"	"Odwiedź forum"
"[english]Store_FriendVisitForums"	"Visit User Forums"
"Store_FriendsOfficialWebsite"	"Odwiedź oficjalną stronę"
"[english]Store_FriendsOfficialWebsite"	"Visit Official Website"
"Store_AppPurchaseSection_Options"	"Opcje zakupu ({i:purchase_option_count})"
"[english]Store_AppPurchaseSection_Options"	"Purchase Options({i:purchase_option_count})"
"Store_NotAvailableForPurchase"	"Nie można zakupić"
"[english]Store_NotAvailableForPurchase"	"Not available for purchase"
"Store_AppPurchaseSection_PurchaseDLC"	"Przejrzyj dostępne DLC ({i:purchase_dlc_count})"
"[english]Store_AppPurchaseSection_PurchaseDLC"	"Browse available DLC ({i:purchase_dlc_count})"
"Store_AppPurchaseSection_Demo"	"Pobierz darmowe demo"
"[english]Store_AppPurchaseSection_Demo"	"Download free demo"
"Store_AppPurchaseSection_AddToWishlist"	"Dodaj do listy życzeń"
"[english]Store_AppPurchaseSection_AddToWishlist"	"Add to wishlist"
"Store_AppPurchaseSection_DLC"	"Zawartość do pobrania"
"[english]Store_AppPurchaseSection_DLC"	"Downloadable Content"
"Store_AppPurchaseSection_RequiresBase"	"Wymaga podstawowej gry {s:base_game} w wersji Steam do działania."
"[english]Store_AppPurchaseSection_RequiresBase"	"Requires the base game {s:base_game} on Steam in order to play."
"Store_AppPurchaseSection_ViewBaseGame"	"Zobacz podstawową grę"
"[english]Store_AppPurchaseSection_ViewBaseGame"	"View Base Game"
"Store_AppPurchaseOptions_Title"	"Opcje zakupu: {i:purchase_option_count}"
"[english]Store_AppPurchaseOptions_Title"	"{i:purchase_option_count} Purchase Options"
"Store_AppPurchaseOptions_AddToCart"	"Dodaj do koszyka"
"[english]Store_AppPurchaseOptions_AddToCart"	"Add to Cart"
"Store_AppPurchaseOptions_InCart"	"W koszyku"
"[english]Store_AppPurchaseOptions_InCart"	"In Cart"
"Store_AppPurchaseOptions_PackageDetails"	"Zobacz szczegóły pakietu"
"[english]Store_AppPurchaseOptions_PackageDetails"	"View Package Details"
"Store_AppPurchaseOptions_PackageOneItem"	"Zawiera"
"[english]Store_AppPurchaseOptions_PackageOneItem"	"Includes"
"Store_AppPurchaseOptions_PackageMultiple"	"Zawiera przedmiotów: {i:package_item_count}"
"[english]Store_AppPurchaseOptions_PackageMultiple"	"Includes {i:package_item_count} Items"
"Store_BrowseByCategory_Title"	"{s:category_title}"
"[english]Store_BrowseByCategory_Title"	"{s:category_title}"
"Store_BrowseByCategory_ItemName"	"{s:item_name}"
"[english]Store_BrowseByCategory_ItemName"	"{s:item_name}"
"Store_BrowseByCategory_ReleaseDate"	"Data wydania"
"[english]Store_BrowseByCategory_ReleaseDate"	"Release Date"
"Store_BrowseByCategory_Available"	"Dostępne"
"[english]Store_BrowseByCategory_Available"	"Available"
"Store_BrowseByCategory_ReleaseDateText"	"{s:release_date}"
"[english]Store_BrowseByCategory_ReleaseDateText"	"{s:release_date}"
"Store_BrowseByCategory_Genre"	"Gatunek"
"[english]Store_BrowseByCategory_Genre"	"Genre"
"Store_Cart_Title"	"Twój koszyk zakupów"
"[english]Store_Cart_Title"	"Your Shopping Cart"
"Store_Cart_ItemsInCart"	"{i:cart_item_count} przedmiot"
"[english]Store_Cart_ItemsInCart"	"{i:cart_item_count} item"
"Store_Cart_ItemsInCartMultiple"	"Przedmiotów: {i:cart_item_count}"
"[english]Store_Cart_ItemsInCartMultiple"	"{i:cart_item_count} items"
"Store_Cart_CouponTotal"	"Zniżki z kuponów"
"[english]Store_Cart_CouponTotal"	"Savings from coupons"
"Store_Cart_Subtotal"	"Suma częściowa"
"[english]Store_Cart_Subtotal"	"Subtotal"
"Store_Cart_Instructions"	"Wybierz opcję zakupu, aby przejść do kasy (przed złożeniem zamówienia będzie można je jeszcze raz przejrzeć)."
"[english]Store_Cart_Instructions"	"Select a purchase option below to begin checkout. (You'll be able to review your purchase before placing your order)"
"Store_Cart_PurchaseForSelf"	"Kup dla siebie"
"[english]Store_Cart_PurchaseForSelf"	"Purchase for yourself"
"Store_Cart_PurchaseAsGift"	"Kup jako prezent"
"[english]Store_Cart_PurchaseAsGift"	"Purchase as a gift"
"Store_Cart_ContinueShopping"	"Kontynuuj zakupy"
"[english]Store_Cart_ContinueShopping"	"Continue shopping"
"Store_Cart_PartiallyOwned"	"Już posiadasz niektóre gry z tego pakietu"
"[english]Store_Cart_PartiallyOwned"	"You already own some items in this bundle"
"Store_Cart_EmptyCart"	"Twój koszyk jest pusty"
"[english]Store_Cart_EmptyCart"	"Your cart is empty"
"Store_Cart_FailedToLoad"	"Nie udało się uzyskać informacji o zawartości koszyka"
"[english]Store_Cart_FailedToLoad"	"Failed to get shopping cart info"
"Store_Cart_UpdatingCart"	"Uaktualnianie koszyka"
"[english]Store_Cart_UpdatingCart"	"Updating cart"
"Store_Cart_FailedToUpdateCart"	"Nie udało się uaktualnić koszyka"
"[english]Store_Cart_FailedToUpdateCart"	"Failed to update cart"
"Store_Cart_RemoveItem"	"USUŃ"
"[english]Store_Cart_RemoveItem"	"REMOVE"
"Store_Cart_SetCouponInstructions"	"Wybierz kupon do użycia na tym produkcie"
"[english]Store_Cart_SetCouponInstructions"	"Select a coupon to apply to this item"
"Store_Cart_DoNotApplyCoupon"	"Żaden. Nie używaj kuponu na tym produkcie."
"[english]Store_Cart_DoNotApplyCoupon"	"None. Don't apply a coupon to this item."
"Store_Cart_SetCouponHeader"	"{s:package_name}"
"[english]Store_Cart_SetCouponHeader"	"{s:package_name}"
"Store_Cart_ExclusiveCouponProhibited"	"Ten kupon nie łączy się z innymi obniżkami."
"[english]Store_Cart_ExclusiveCouponProhibited"	"This coupon cannot be used in conjunction with another discount."
"Store_Cart_SetCoupon"	"Wybierz kupon"
"[english]Store_Cart_SetCoupon"	"Set Coupon"
"Checkout_VerifyEmail_Title"	"Weryfikacja adresu e-mail"
"[english]Checkout_VerifyEmail_Title"	"Email Verification"
"Checkout_VerifyEmail_Instructions"	"Zweryfikuj adres e-mail wykorzystywany w Steam."
"[english]Checkout_VerifyEmail_Instructions"	"Please verify your email address with Steam."
"Checkout_VerifyEmail_Description"	"Ta jednorazowa czynność pozwoli ci utrzymać bezpieczeństwo swojego konta Steam i jest wymagana do ukończenia transakcji przez Steam. \n\n\n\nWłaśnie wysłaliśmy ci wiadomość ze Wsparcia Steam na twój adres e-mail."
"[english]Checkout_VerifyEmail_Description"	"This one-time step helps us maintain the security of your Steam account and is required in order to complete your purchase with Steam.\n\nWe've just sent a message from Steam Support to your address on record at valvesoftware.com."
"Checkout_VerifyEmail_CheckEmail"	"Sprawdź teraz swój e-mail w  valvesoftware.com, następnie kliknij link otrzymany w wiadomości od pomocy technicznej Steam..."
"[english]Checkout_VerifyEmail_CheckEmail"	"Check your email at valvesoftware.com now, and click the link within the message from Steam Support..."
"Checkout_VerifyEmail_CanCompleteAfter"	"Proces zakupów może być dokończony po powrocie do tego ekranu."
"[english]Checkout_VerifyEmail_CanCompleteAfter"	"Your purchase can then be completed once you return to this screen."
"Checkout_VerifyEmail_Success"	"Sukces! Twój adres e-mail został zweryfikowany."
"[english]Checkout_VerifyEmail_Success"	"Success! Your email address has been verified."
"Checkout_VerifyEmail_Thanks"	"Dziękujemy za pomoc w utrzymaniu bezpieczeństwa twojego konta! Możesz teraz kontynuować swoje zakupy."
"[english]Checkout_VerifyEmail_Thanks"	"Thanks for helping us maintain the security of your account! You may now continue with your purchase."
"Checkout_PaymentStep_Method"	"Informacje o płatności"
"[english]Checkout_PaymentStep_Method"	"Payment Info"
"Checkout_PaymentStep_Review"	"Sprawdź i kup"
"[english]Checkout_PaymentStep_Review"	"Review + Purchase"
"Checkout_PaymentStep_GiftDelivery"	"Przekazanie prezentu"
"[english]Checkout_PaymentStep_GiftDelivery"	"Gift Delivery"
"Checkout_PaymentStep_GiftNote"	"Notka do prezentu"
"[english]Checkout_PaymentStep_GiftNote"	"Gift Note"
"Checkout_Continue"	"Kontynuuj"
"[english]Checkout_Continue"	"Continue"
"Checkout_Processing"	"Przetwarzanie"
"[english]Checkout_Processing"	"Processing"
"Checkout_WaitExternalAuth"	"Oczekiwanie na autoryzację {s:payment_method} poprzez przeglądarkę"
"[english]Checkout_WaitExternalAuth"	"Waiting for {s:payment_method} authorization through browser"
"Checkout_GiftRecipient_Title"	"Przekazanie prezentu"
"[english]Checkout_GiftRecipient_Title"	"Gift Delivery"
"Checkout_GiftRecipient_HowToSend"	"W jaki sposób chcesz wysłać swój prezent?"
"[english]Checkout_GiftRecipient_HowToSend"	"How would you like to send your gift?"
"Checkout_GiftRecipient_EmailGift"	"Prześlij pocztą e-mail"
"[english]Checkout_GiftRecipient_EmailGift"	"Email my gift"
"Checkout_GiftRecipient_EmailGiftAddress"	"Adres e-mail"
"[english]Checkout_GiftRecipient_EmailGiftAddress"	"Email address"
"Checkout_GiftRecipient_SendToFriend"	"Prześlij bezpośrednio przez Steam"
"[english]Checkout_GiftRecipient_SendToFriend"	"Send my gift directly through Steam"
"Checkout_GiftRecipient_SendToInventory"	"Przechowaj prezent w moim ekwipunku, aby wysłać go później"
"[english]Checkout_GiftRecipient_SendToInventory"	"Store the gift in my inventory to send later"
"Checkout_GiftRecipient_EmailInstructions"	"Wyślij znajomemu prezent przez wiadomość e-mail, która będzie zawierać wszelkie niezbędne informacje, które pozwolą znajomemu zainstalować Steam i uruchomić podarowaną grę."
"[english]Checkout_GiftRecipient_EmailInstructions"	"Send my friend a gift email message, including all the info they'll need to get up and running on Steam."
"Checkout_GiftRecipient_EmailHeader"	"Adres e-mail odbiorcy"
"[english]Checkout_GiftRecipient_EmailHeader"	"Recipient's email address"
"Checkout_GiftRecipient_FriendInstructions"	"Wybierz znajomego z listy poniżej, aby wysłać swój zakup jako prezent prosto na jego konto Steam."
"[english]Checkout_GiftRecipient_FriendInstructions"	"Select a friend from the list below to send your purchase as a gift directly to their Steam account."
"Checkout_GiftRecipient_FriendWishes"	"Marzy o {s:wish_for_games}"
"[english]Checkout_GiftRecipient_FriendWishes"	"Wishes for {s:wish_for_games}"
"Checkout_GiftRecipient_FriendOwns"	"Posiada już {s:already_owns_games}"
"[english]Checkout_GiftRecipient_FriendOwns"	"Already owns {s:already_owns_games}"
"Checkout_GiftRecipient_Inventoryinstructions"	"Twój prezent zostanie przechowany na twoim koncie, aby mógł zostać podarowany lub wymieniony w przyszłości. Możesz zarządzać swoimi prezentami przez klienta Steam w zakładce „Ekwipunek Steam” w swoim profilu."
"[english]Checkout_GiftRecipient_Inventoryinstructions"	"Your gift will be kept on your account, to be delivered or traded later. You can manage your gifts in the Steam client or by viewing your Steam Inventory on your Community profile."
"Checkout_Sentiment_BestWishes"	"Z najlepszymi życzeniami"
"[english]Checkout_Sentiment_BestWishes"	"Best Wishes"
"Checkout_Sentiment_BuckleUp"	"Zapnij pasy"
"[english]Checkout_Sentiment_BuckleUp"	"Buckle Up"
"Checkout_Sentiment_Enjoy"	"Dobrej zabawy"
"[english]Checkout_Sentiment_Enjoy"	"Enjoy"
"Checkout_Sentiment_GameOn"	"Rozgrywkę czas zacząć"
"[english]Checkout_Sentiment_GameOn"	"Game On"
"Checkout_Sentiment_HaveFun"	"Dobrej zabawy"
"[english]Checkout_Sentiment_HaveFun"	"Have Fun"
"Checkout_Sentiment_KerBlam"	"Padnij!"
"[english]Checkout_Sentiment_KerBlam"	"Ker Blam"
"Checkout_Sentiment_OverOut"	"Bez odbioru"
"[english]Checkout_Sentiment_OverOut"	"Over n' Out"
"Checkout_Sentiment_YouOweMe"	"Masz u mnie dług"
"[english]Checkout_Sentiment_YouOweMe"	"You Owe Me"
"Checkout_Sentiment_YourTurn"	"Twoja kolej"
"[english]Checkout_Sentiment_YourTurn"	"Your Turn"
"Checkout_Sentiment_XOXO"	"XOXOXO"
"[english]Checkout_Sentiment_XOXO"	"XOXOXO"
"Checkout_GiftNote_Title"	"Notka do prezentu"
"[english]Checkout_GiftNote_Title"	"Gift Note"
"Checkout_GiftNote_Instructions"	"Dodaj do prezentu krótką notkę"
"[english]Checkout_GiftNote_Instructions"	"Personalize your gift with a little note"
"Checkout_GiftNote_RecipientName"	"Imię odbiorcy"
"[english]Checkout_GiftNote_RecipientName"	"Recipient's first name"
"Checkout_GiftNote_Message"	"Wiadomość do prezentu"
"[english]Checkout_GiftNote_Message"	"Gift message"
"Checkout_GiftNote_MessageRemaining"	"(pozostało {i:message_remaining} znaków)"
"[english]Checkout_GiftNote_MessageRemaining"	"({i:message_remaining} char left)"
"Checkout_GiftNote_Sentiment"	"Twoje pozdrowienia"
"[english]Checkout_GiftNote_Sentiment"	"Your sentiment"
"Checkout_GiftNote_Signature"	"Twój podpis"
"[english]Checkout_GiftNote_Signature"	"Your signature"
"Checkout_PaymentMethod_Title"	"Sposób płatności"
"[english]Checkout_PaymentMethod_Title"	"Payment method"
"Checkout_PaymentMethod_Instructions"	"Wybierz sposób płatności"
"[english]Checkout_PaymentMethod_Instructions"	"Please select a payment method"
"Checkout_PaymentMethod_Secondary"	"Dodatkowa metoda"
"[english]Checkout_PaymentMethod_Secondary"	"Secondary method"
"Checkout_PaymentMethod_CartNumber"	"Numer karty"
"[english]Checkout_PaymentMethod_CartNumber"	"Card number"
"Checkout_PaymentMethod_ExpirationDate"	"Data ważności"
"[english]Checkout_PaymentMethod_ExpirationDate"	"Expiration date"
"Checkout_PaymentMethod_SecurityCode"	"Kod zabezpieczający"
"[english]Checkout_PaymentMethod_SecurityCode"	"Security code"
"Checkout_PaymentMethod_SaveInfo"	"Zapisz informacje o metodzie płatności"
"[english]Checkout_PaymentMethod_SaveInfo"	"Save my payment information"
"Checkout_PaymentMethod_PayPalInstructions"	"Transakcje PayPal są autoryzowane przez stronę internetową PayPal."
"[english]Checkout_PaymentMethod_PayPalInstructions"	"PayPal transactions are authorized through the PayPal web site."
"Checkout_PaymentMethod_ClickAndBuyInstructions"	"Transakcje ClickandBuy są autoryzowane przez stronę internetową ClickandBuy. Kliknij przycisk kontynuacji, aby otworzyć nowe okno przeglądarki i rozpocząć transakcję."
"[english]Checkout_PaymentMethod_ClickAndBuyInstructions"	"ClickandBuy transactions are authorized through the ClickandBuy web site. Press continue to open a new web browser window to initiate the transaction."
"Checkout_PaymentMethod_ClickAndBuySaved"	"Informacje o twoim koncie ClickandBuy zostały poprzednio zapisane i zostaną użyte przy bieżącej płatności."
"[english]Checkout_PaymentMethod_ClickAndBuySaved"	"Your ClickandBuy account information was previously saved and will be used again for this purchase."
"Checkout_PaymentMethod_LogoHeader"	"Akceptujemy następujące metody dokonywania bezpiecznych płatności"
"[english]Checkout_PaymentMethod_LogoHeader"	"We accept the following secure payment methods"
"Checkout_PaymentMethod_VerifyCountry"	"Potwierdzam, że mieszkam w {s:country}"
"[english]Checkout_PaymentMethod_VerifyCountry"	"I verify that I live in {s:country}"
"Checkout_PaymentMethod_WalletLow"	"Zawartość twojego portfela Steam jest zbyt mała, aby można było pokryć w całości tę transakcję!\n\nWybierz metodę płatności do pokrycia brakujących {s:purchase_balance}."
"[english]Checkout_PaymentMethod_WalletLow"	"Your Steam Wallet balance is too low to cover this transaction!\n\nPlease select a payment method for the remaining {s:purchase_balance}."
"Checkout_PaymentMethod_ClickandBuy"	"ClickandBuy"
"[english]Checkout_PaymentMethod_ClickandBuy"	"ClickandBuy"
"Checkout_BillingInfo_Title"	"Adres billingowy"
"[english]Checkout_BillingInfo_Title"	"Billing address"
"Checkout_BillingInfo_FirstName"	"Imię"
"[english]Checkout_BillingInfo_FirstName"	"First name"
"Checkout_BillingInfo_LastName"	"Nazwisko"
"[english]Checkout_BillingInfo_LastName"	"Last name"
"Checkout_BillingInfo_Address1"	"Adres billingowy"
"[english]Checkout_BillingInfo_Address1"	"Billing address"
"Checkout_BillingInfo_Address2"	"Adres billingowy - linijka 2"
"[english]Checkout_BillingInfo_Address2"	"Billing address, line 2"
"Checkout_BillingInfo_Country"	"Kraj"
"[english]Checkout_BillingInfo_Country"	"Country"
"Checkout_BillingInfo_LiveInCountry"	"Mieszkam w powyższym kraju"
"[english]Checkout_BillingInfo_LiveInCountry"	"I currently live in the country selected above"
"Checkout_BillingInfo_City"	"Miasto"
"[english]Checkout_BillingInfo_City"	"City"
"Checkout_BillingInfo_State"	"Stan"
"[english]Checkout_BillingInfo_State"	"State"
"Checkout_BillingInfo_PostCode"	"Kod pocztowy"
"[english]Checkout_BillingInfo_PostCode"	"Zip or postal code"
"Checkout_BillingInfo_PhoneNumber"	"Telefon"
"[english]Checkout_BillingInfo_PhoneNumber"	"Phone number"
"Checkout_BillingInfo_SelectState"	"Wybierz stan lub województwo"
"[english]Checkout_BillingInfo_SelectState"	"Select state"
"Checkout_Review_Title"	"Przejrzyj i kup"
"[english]Checkout_Review_Title"	"Review & Purchase"
"Checkout_Review_Purchase"	"Zakup"
"[english]Checkout_Review_Purchase"	"Purchase"
"Checkout_Review_EditPayment"	"Zmień metodę płatności"
"[english]Checkout_Review_EditPayment"	"Edit Payment Method"
"Checkout_Review_AgreeTerms"	"Zgadzam się z warunkami umowy użytkownika Steam (ostatnio zaktualizowana 11.12.2012)."
"[english]Checkout_Review_AgreeTerms"	"I agree to the terms of the Steam Subscriber Agreement (last updated 12/11/2012.)"
"Checkout_Review_PaymentMethod"	"Sposób płatności"
"[english]Checkout_Review_PaymentMethod"	"Payment Method"
"Checkout_Review_GiftOptions"	"Opcje prezentu"
"[english]Checkout_Review_GiftOptions"	"Gift Options"
"Checkout_Review_BillingAddress"	"Adres billingowy"
"[english]Checkout_Review_BillingAddress"	"Billing Address"
"Checkout_Review_Phone"	"Telefon"
"[english]Checkout_Review_Phone"	"Phone"
"Checkout_Review_Subtotal"	"Suma częściowa"
"[english]Checkout_Review_Subtotal"	"Subtotal"
"Checkout_Review_Tax"	"Podatek"
"[english]Checkout_Review_Tax"	"Tax"
"Checkout_Review_Total"	"Razem"
"[english]Checkout_Review_Total"	"Total"
"Checkout_Review_NoGift"	"Żaden, kupuję dla siebie."
"[english]Checkout_Review_NoGift"	"None, this purchase is for your account."
"Checkout_Review_CreditCard"	"{s:card_type} kończąca się cyframi {s:card_last4}"
"[english]Checkout_Review_CreditCard"	"{s:card_type} ending in {s:card_last4}"
"Checkout_Review_GiftSend"	"Twój prezent dla użytkownika {s:giftee} zostanie wysłany tuż po ukończeniu transakcji."
"[english]Checkout_Review_GiftSend"	"Your gift purchase for {s:giftee} will be sent upon completion of your purchase."
"Checkout_Review_GiftKept"	"Przedmioty z twojego koszyka zostaną przechowane w twoim Ekwipunku Steam, aby mogły zostać wysłane lub wymienione później."
"[english]Checkout_Review_GiftKept"	"The items in your cart will be stored in your Steam Inventory, to be sent or redeemed later."
"Checkout_Review_VAT"	"Wszystkie ceny zawierają podatek VAT (jeśli wymagany)"
"[english]Checkout_Review_VAT"	"All prices include VAT where applicable"
"Checkout_Confirmation_Title"	"Dziękujemy za dokonanie zakupu!"
"[english]Checkout_Confirmation_Title"	"Thank you for your purchase!"
"Checkout_Confirmation_ReceiptEmail"	"Rachunek zostanie niebawem wysłany na twój adres e-mail."
"[english]Checkout_Confirmation_ReceiptEmail"	"A receipt will be emailed to you shortly."
"Checkout_Confirmation_ToAccessGames"	"Twoje dostarczone cyfrowo gry są teraz przypisane do twojego konta Steam. Aby uzyskać do nich dostęp, po prostu zajrzyj do zakładki „Biblioteka” w kliencie Steam i zainstaluj je, kiedy tylko zechcesz."
"[english]Checkout_Confirmation_ToAccessGames"	"Your digitally delivered items are now registered to your account on Steam. To access your games, simply visit your game library in Steam and install them whenever you're ready."
"Checkout_Confirmation_ReceiptTextHeader"	"Potwierdzenie zakupu"
"[english]Checkout_Confirmation_ReceiptTextHeader"	"Your purchase receipt"
"Checkout_Confirmation_ReceiptText"	"Poniżej załączono potwierdzenie zakupu. Niebawem informacje te zostaną również przesłane do ciebie za pośrednictwem poczty e-mail."
"[english]Checkout_Confirmation_ReceiptText"	"Confirmation of your purchase is provided below. This information will also be emailed to you shortly."
"Checkout_Confirmation_AccountName"	"Nazwa konta"
"[english]Checkout_Confirmation_AccountName"	"Account name"
"Checkout_Confirmation_Total"	"Razem"
"[english]Checkout_Confirmation_Total"	"Total"
"Checkout_Confirmation_Code"	"Kod potwierdzenia"
"[english]Checkout_Confirmation_Code"	"Confirmation code"
"Checkout_Confirmation_GoToLibrary"	"Przejdź do swojej biblioteki"
"[english]Checkout_Confirmation_GoToLibrary"	"Go to your library"
"Checkout_Confirmation_ReturnToStore"	"Wróć do sklepu"
"[english]Checkout_Confirmation_ReturnToStore"	"Return to the store"
"Library_RecentlyPlayed"	"OSTATNIO GRANE"
"[english]Library_RecentlyPlayed"	"RECENTLY PLAYED"
"Library_ViewAll"	"Wszystkie"
"[english]Library_ViewAll"	"VIEW ALL"
"Library_Games"	"GRY"
"[english]Library_Games"	"GAMES"
"Library_Movies"	"FILMY"
"[english]Library_Movies"	"MOVIES"
"Library_Music"	"MUZYKA"
"[english]Library_Music"	"MUSIC"
"Library_Details_LinksAndMore"	"LINKI I WIĘCEJ"
"[english]Library_Details_LinksAndMore"	"LINKS & MORE"
"Library_Details_Achievements"	"OSIĄGNIĘCIA"
"[english]Library_Details_Achievements"	"ACHIEVEMENTS"
"Library_Details_Play"	"GRAJ"
"[english]Library_Details_Play"	"PLAY"
"Library_Details_ComingSoon"	"WKRÓTCE"
"[english]Library_Details_ComingSoon"	"COMING SOON"
"Library_Details_Preload"	"POBIERZ WSTĘPNIE"
"[english]Library_Details_Preload"	"PRELOAD"
"Library_Details_ActivateGuestPass"	"AKTYWUJ"
"[english]Library_Details_ActivateGuestPass"	"ACTIVATE"
"Library_Details_Install"	"ZAINSTALUJ"
"[english]Library_Details_Install"	"INSTALL"
"Library_Details_Installing"	"POBIERANIE"
"[english]Library_Details_Installing"	"DOWNLOADING"
"Library_Details_Launch"	"URUCHOM"
"[english]Library_Details_Launch"	"LAUNCH"
"Library_Details_Launching"	"URUCHAMIANIE"
"[english]Library_Details_Launching"	"LAUNCHING"
"Library_Details_Purchase"	"KUP"
"[english]Library_Details_Purchase"	"PURCHASE"
"Library_Details_FriendsWhoPlay"	"ZNAJOMI, KTÓRZY GRALI"
"[english]Library_Details_FriendsWhoPlay"	"FRIENDS WHO PLAY"
"Library_Details_Workshop"	"WARSZTAT"
"[english]Library_Details_Workshop"	"WORKSHOP"
"Library_Details_Screenshots"	"ZRZUTY EKRANU"
"[english]Library_Details_Screenshots"	"SCREENSHOTS"
"Library_Details_RecentNews"	"NAJNOWSZE WIADOMOŚCI"
"[english]Library_Details_RecentNews"	"RECENT NEWS"
"Library_Details_Achievements_MostRecent"	"NAJNOWSZE"
"[english]Library_Details_Achievements_MostRecent"	"MOST RECENT"
"Library_Details_Achievements_SoClose"	"TAK BLISKO..."
"[english]Library_Details_Achievements_SoClose"	"SO CLOSE..."
"Library_Details_Achievements_MoreUnachieved"	"NADAL DO ZDOBYCIA"
"[english]Library_Details_Achievements_MoreUnachieved"	"MORE UNACHIEVED"
"Library_Details_YouvePlayed"	"GRANO PRZEZ"
"[english]Library_Details_YouvePlayed"	"YOU'VE PLAYED"
"Library_Details_LastPlayed"	"OSTATNIO GRANE"
"[english]Library_Details_LastPlayed"	"LAST PLAYED"
"Library_Details_LastPlayedValue"	"{t:r:lastplayed}"
"[english]Library_Details_LastPlayedValue"	"{t:r:lastplayed}"
"Library_Details_SteamCloud"	"STEAM CLOUD"
"[english]Library_Details_SteamCloud"	"STEAM CLOUD"
"Library_Details_Minutes"	"{i:minutes} min"
"[english]Library_Details_Minutes"	"{i:minutes} Minutes"
"Library_Details_Hours"	"{i:hours} godz."
"[english]Library_Details_Hours"	"{i:hours} Hours"
"Library_Details_MinutesSingular"	"{i:minutes} minutę"
"[english]Library_Details_MinutesSingular"	"{i:minutes} Minute"
"Library_Details_HoursSingulare"	"{i:hours} godzinę"
"[english]Library_Details_HoursSingulare"	"{i:hours} Hour"
"Library_Details_Synchronized"	"Zsynchronizowano"
"[english]Library_Details_Synchronized"	"Synchronized"
"Library_Details_Syncing"	"Synchronizacja..."
"[english]Library_Details_Syncing"	"Syncing..."
"Library_Details_NeedsSync"	"Synchr. wymagana"
"[english]Library_Details_NeedsSync"	"Sync Needed"
"Library_Details_SyncingConflict"	"Konflikt"
"[english]Library_Details_SyncingConflict"	"Conflict"
"Library_Details_CloudUnknown"	"Nieznany"
"[english]Library_Details_CloudUnknown"	"Unknown"
"Library_Details_DownloadableContent"	"Zawartość do pobrania"
"[english]Library_Details_DownloadableContent"	"Downloadable Content"
"Library_Details_GameStorePage"	"Strona gry w sklepie"
"[english]Library_Details_GameStorePage"	"Game Store Page"
"Library_Details_GameForums"	"Fora gier"
"[english]Library_Details_GameForums"	"Game Forums"
"Library_Details_RelatedGroups"	"Powiązane grupy"
"[english]Library_Details_RelatedGroups"	"Related Groups"
"Library_Details_Support"	"Wsparcie"
"[english]Library_Details_Support"	"Support"
"Library_Details_RecommendThisGame"	"Poleć tę grę..."
"[english]Library_Details_RecommendThisGame"	"Recommend this Game..."
"Library_Details_SetCategory"	"Edytuj kategorie..."
"[english]Library_Details_SetCategory"	"Set Category..."
"Library_Details_DeleteLocalContent"	"Usuń zawartość lokalną"
"[english]Library_Details_DeleteLocalContent"	"Delete Local Content"
"Library_Details_NewsByline"	"{s:feed} | {t:l:date}"
"[english]Library_Details_NewsByline"	"{s:feed} | {t:l:date}"
"Library_Details_ScreenshotHowTo1"	"Skrót w grze"
"[english]Library_Details_ScreenshotHowTo1"	"In-game shortcut"
"Library_Details_ViewAllScreenshots"	"Wyświetl wszystkie zrzuty ekranu ({s:sscount})"
"[english]Library_Details_ViewAllScreenshots"	"View all screenshots ({s:sscount})"
"Library_Details_ViewAllAchievements"	"WSZYSTKIE"
"[english]Library_Details_ViewAllAchievements"	"VIEW ALL"
"Library_Details_WorkshopWhatIsIt"	"Twórz, odkrywaj i odtwarzaj zawartość opublikowaną przez Społeczność Steam."
"[english]Library_Details_WorkshopWhatIsIt"	"Create, discover and play content contributed by the Steam Community."
"Library_Details_BrowseWorkshop"	"Przeglądaj Warsztat ({s:wscount})"
"[english]Library_Details_BrowseWorkshop"	"Browse the Workshop ({s:wscount})"
"Library_AllGames_Header"	"GRY"
"[english]Library_AllGames_Header"	"GAMES"
"Library_AllGames"	"Wszystkie gry ({d:games})"
"[english]Library_AllGames"	"All Games ({d:games})"
"Library_Installed"	"Zainstalowane ({d:installed})"
"[english]Library_Installed"	"Installed ({d:installed})"
"Library_Favorites"	"Ulubione ({d:favorites})"
"[english]Library_Favorites"	"Favorites ({d:favorites})"
"Library_RecentlyPlayedFilter"	"Ostatnie ({d:recent})"
"[english]Library_RecentlyPlayedFilter"	"Recent ({d:recent})"
"Library_ListView"	"WIDOK LISTY"
"[english]Library_ListView"	"LIST VIEW"
"Library_GridView"	"WIDOK SIATKI"
"[english]Library_GridView"	"GRID VIEW"
"Library_AddContent"	"+"
"[english]Library_AddContent"	"+"
"Library_LaunchOptions"	"Opcje uruchamiania"
"[english]Library_LaunchOptions"	"Launch Options"
"Library_LaunchOption_Game"	"Uruchom {s:gamename}"
"[english]Library_LaunchOption_Game"	"Play {s:gamename}"
"Library_LaunchOption_Application"	"Uruchom {s:gamename}"
"[english]Library_LaunchOption_Application"	"Launch {s:gamename}"
"Library_LaunchOption_Cancel"	"Anuluj"
"[english]Library_LaunchOption_Cancel"	"Cancel"
"Library_LaunchEulaTitle"	"Umowa licencyjna użytkownika końcowego"
"[english]Library_LaunchEulaTitle"	"End User License Agreement"
"Library_LaunchEULA_Agree"	"Zgadzam się"
"[english]Library_LaunchEULA_Agree"	"Agree"
"Library_LaunchEULA_Cancel"	"Anuluj"
"[english]Library_LaunchEULA_Cancel"	"Cancel"
"Library_LaunchEULA_Detail"	"Zapoznaj się dokładnie z tą umową. Musisz zgodzić się z jej warunkami, aby grać w {s:gamename}."
"[english]Library_LaunchEULA_Detail"	"Please read this agreement in its entirety.  You must agree with the terms of the EULA to play {s:gamename}."
"Library_WaitingOnGamesTitle"	"Proszę czekać"
"[english]Library_WaitingOnGamesTitle"	"Please Wait"
"Library_WaitingOnGamesDesc"	"Steam skanuje konfigurację twojego komputera i wyszukuje aktualizacje, proszę czekać{s:progress}"
"[english]Library_WaitingOnGamesDesc"	"Steam is scanning for configuration and game updates, please wait{s:progress}"
"Library_WaitingOnGamesCancel"	"Anuluj"
"[english]Library_WaitingOnGamesCancel"	"Cancel"
"Library_JoinDialog_InstallScript"	"Trwa konfiguracja wstępna..."
"[english]Library_JoinDialog_InstallScript"	"Performing first time setup..."
"Library_JoinDialog_InstallScriptDetailed"	"Uruchamianie pierwszej instalacji...\n\nInstalowanie: {S:stepname} (krok {d:step} z {d:steptotal})"
"[english]Library_JoinDialog_InstallScriptDetailed"	"Performing first time setup...\n\nInstalling {S:stepname} (step {d:step} of {d:steptotal})"
"Library_Details_ManageAccount"	"Zarządzaj kontem"
"[english]Library_Details_ManageAccount"	"Manage Account"
"Library_ExternalSignupTitle"	"Konto {s:gamename}"
"[english]Library_ExternalSignupTitle"	"{s:gamename} Account"
"Library_ExternalSignupDesc"	"Aby zakończyć instalację, musisz połączyć swój zakup na Steam ze swoim kontem zawierającym {s:gamename}.\n\nOdwiedź oficjalną stronę, aby zalogować się do swojego konta zawierającego {s:gamename} lub utworzyć nowe."
"[english]Library_ExternalSignupDesc"	"To complete installation you need to link your Steam purchase with your {s:gamename} account.\n\nVisit their official web site now to login to your existing {s:gamename} account or to create a new one."
"Library_GotoExternalSignup"	"Odwiedź stronę rejestracji"
"[english]Library_GotoExternalSignup"	"Visit Signup Site"
"Library_SkipExternalSignup"	"Później"
"[english]Library_SkipExternalSignup"	"Later"
"Library_ScreenshotsSlideshowTitle"	"{s:gamename}"
"[english]Library_ScreenshotsSlideshowTitle"	"{s:gamename}"
"Library_ScreenshotTakenOn"	"{t:l:timetaken}"
"[english]Library_ScreenshotTakenOn"	"{t:l:timetaken}"
"Library_ShareScreenshot"	"UDOSTĘPNIJ"
"[english]Library_ShareScreenshot"	"SHARE"
"Library_ViewThisScreenshotOnline"	"ZOBACZ ONLINE"
"[english]Library_ViewThisScreenshotOnline"	"VIEW ONLINE"
"Library_DeleteScreenshot"	"USUŃ"
"[english]Library_DeleteScreenshot"	"DELETE"
"SteamUI_JoinDialog_DataRequest_Text"	"Finalizowanie instalacji... {d:progress}%"
"[english]SteamUI_JoinDialog_DataRequest_Text"	"Completing installation ... {d:progress}%"
"Notification_GameInviteBody"	"zaprasza cię do gry w {s:gamename}"
"[english]Notification_GameInviteBody"	"invites you to play {s:gamename}"
"Notification_TheSteamCommunity"	"Społeczność Steam"
"[english]Notification_TheSteamCommunity"	"The Steam Community"
"Notification_AccessWhilePlaying"	"Dostęp podczas gry"
"[english]Notification_AccessWhilePlaying"	"Access while playing"
"Notification_HasFinishedDownload"	"Pobieranie zakończone"
"[english]Notification_HasFinishedDownload"	"download complete"
"Notification_IsNowOnline"	"jest online"
"[english]Notification_IsNowOnline"	"is now online"
"Notification_IsNowPlaying"	"gra teraz w {s:gamename}"
"[english]Notification_IsNowPlaying"	"is now playing {s:gamename}"
"Notification_BannedFromChat"	"zablokował(a) twój dostęp do czatu {s:chatname}"
"[english]Notification_BannedFromChat"	"banned you from {s:chatname} chat"
"Notification_KickedFromChat"	"wyrzuca cię z czatu {s:chatname}"
"[english]Notification_KickedFromChat"	"kicked you from {s:chatname} chat"
"Notification_VoiceChat"	"zaprasza cię do czatu głosowego"
"[english]Notification_VoiceChat"	"invites you to voice chat"
"Notification_ChatInvite"	"zaprasza cię do czatu {s:chatname}"
"[english]Notification_ChatInvite"	"invites you to {s:chatname} chat"
"Notification_FriendInvite"	"zaprasza cię do znajomych"
"[english]Notification_FriendInvite"	"invites you to be friends"
"Notification_TradeInvite"	"zaprasza cię do wymiany"
"[english]Notification_TradeInvite"	"invites you to trade"
"Notification_HasSentYouAGift"	"przesyła ci prezent"
"[english]Notification_HasSentYouAGift"	"has sent you a gift"
"Notification_ItemReceivedSingular"	"Masz 1 nowy przedmiot w swoim ekwipunku"
"[english]Notification_ItemReceivedSingular"	"You have 1 new item in your inventory"
"Notification_ItemsReceived"	"Nowe przedmioty w twoim ekwipunku: {d:numItems}"
"[english]Notification_ItemsReceived"	"You have {d:numItems} new items in your inventory"
"Notification_ClanInvite"	"Zaproszono cię do grupy: {s:clanname}"
"[english]Notification_ClanInvite"	"You are invited to join the group: {s:clanname}"
"Notification_StatusUpdate"	"mówi: {s:statustext}"
"[english]Notification_StatusUpdate"	"says: {s:statustext}"
"Notification_ClanEvent"	"{s:clanname} {s:action}: {s:event}"
"[english]Notification_ClanEvent"	"{s:clanname} {s:action}: {s:event}"
"Notification_AchievementHeadline_Unlocked"	"Odblokowano osiągnięcie!"
"[english]Notification_AchievementHeadline_Unlocked"	"Achievement Unlocked!"
"Notification_AchievementHeadline_Progress"	"Postęp w osiągnięciu"
"[english]Notification_AchievementHeadline_Progress"	"Achievement Progress"
"Notification_AchievementBody_Unlocked"	"{s:achievement}"
"[english]Notification_AchievementBody_Unlocked"	"{s:achievement}"
"Notification_AchievementBody_Progress"	"{s:achievement} ({s:cur}/{s:max})"
"[english]Notification_AchievementBody_Progress"	"{s:achievement} ({s:cur}/{s:max})"
"Notification_ScreenshotTaken"	"Zrobiono zrzut ekranu!"
"[english]Notification_ScreenshotTaken"	"Screenshot taken!"
"Notification_MultipleScreenshotsTaken"	"{d:numscreenshots} zrobionych zrzutów ekranu!"
"[english]Notification_MultipleScreenshotsTaken"	"{d:numscreenshots} screenshots taken!"
"Friends_GroupEvent_NowStarting"	"- w grupie rozpoczyna się wydarzenie"
"[english]Friends_GroupEvent_NowStarting"	"has event starting"
"Friends_GroupEvent_NewEventScheduled"	"- grupa zaplanowała wydarzenie"
"[english]Friends_GroupEvent_NewEventScheduled"	"has scheduled an event"
"Friends_GroupEvent_NewAccouncement"	"zamieszcza ogłoszenie"
"[english]Friends_GroupEvent_NewAccouncement"	"has posted an announcement"
"Steam_DeleteCacheConfirmation_Title"	"Usunąć zawartość?"
"[english]Steam_DeleteCacheConfirmation_Title"	"Delete Content?"
"Steam_DeleteCacheConfirmation_Text"	"Cała zawartość {s:gamename} zostanie usunięta z tego komputera.\n\nGra pozostanie w Bibliotece, ale aby zagrać w nią w przyszłości, musisz najpierw ponownie\npobrać jej zawartość."
"[english]Steam_DeleteCacheConfirmation_Text"	"This will delete all {s:gamename} content from this computer.\n\nThe game will remain in your Library, but to play it in the future you'll have to re-download its content."
"Steam_DeleteFreeCacheConfirmation_Text"	"Usunie to wszelką zawartość {s:gamename} z tego komputera."
"[english]Steam_DeleteFreeCacheConfirmation_Text"	"This will delete all {s:gamename} content from this computer."
"Steam_CantDeleteCache_Title"	"Steam - Nie można usunąć {s:gamename}"
"[english]Steam_CantDeleteCache_Title"	"Steam - Cannot delete {s:gamename}"
"Steam_CantDeleteCache_Info"	"Nie można usunąć {s:gamename}, ponieważ ta zawartość jest używana przez następujące gry: {s:dependantgames}"
"[english]Steam_CantDeleteCache_Info"	"Cannot delete {s:gamename}, since its data is used by the following games: {s:dependantgames}"
"Steam_CantDeleteAppItsRunning_Info"	"Nie można usunąć {s:gamename}, ponieważ obecnie pracuje. Zamknij {s:gamename}, zanim przystąpisz do próby usunięcia."
"[english]Steam_CantDeleteAppItsRunning_Info"	"Cannot delete {s:gamename}, since it's currently running.  Please close {s:gamename} before attempting to delete it."
"SteamUI_SecuROM_Revoke_Error_Title"	"Steam – błąd odinstalowywania"
"[english]SteamUI_SecuROM_Revoke_Error_Title"	"Steam - Uninstall failed"
"SteamUI_SecuROM_Revoke_Error_Text"	"Odinstalowanie tej aplikacji wymaga połączenia z Internetem."
"[english]SteamUI_SecuROM_Revoke_Error_Text"	"Uninstalling this application requires an internet connection."
"SteamUI_OldClient_Title"	"Nieaktualny"
"[english]SteamUI_OldClient_Title"	"Out of date"
"SteamUI_OldClient"	"Aby móc uruchomić tę grę, należy zaktualizować klienta Steam."
"[english]SteamUI_OldClient"	"Your client needs to be updated to run this game."
"SteamUI_ParentalControl_Title"	"Kontrola rodzicielska systemu Windows"
"[english]SteamUI_ParentalControl_Title"	"Windows Parental Control"
"SteamUI_ParentalControl_Blocked"	"Gra została zablokowana dla aktualnego użytkownika przez funkcję Kontrola rodzicielska systemu Windows."
"[english]SteamUI_ParentalControl_Blocked"	"Game blocked for current user by Windows Parental Control."
"SteamUI_WrongPlatform_Title"	"Gra niedostępna"
"[english]SteamUI_WrongPlatform_Title"	"Game Unavailable"
"SteamUI_WrongPlatform"	"{s:gamename} nie jest dostępna na twojej platformie sprzętowej."
"[english]SteamUI_WrongPlatform"	"{s:gamename} is not available on your current platform."
"SteamUI_Game_Requires_NTFS"	"Gra wymaga systemu plików NTFS"
"[english]SteamUI_Game_Requires_NTFS"	"Game requires NTFS"
"SteamUI_GameRequires_NTFS_Detail"	"Instalowana gra wymaga dysku z systemem plików NTFS i nie może być zainstalowana na systemie FAT32."
"[english]SteamUI_GameRequires_NTFS_Detail"	"The game you are installing requires a drive with the NTFS file system and cannot be installed on a FAT32 filesystem."
"SteamUI_OfflineMode_GameNotReady"	"Ta gra nie jest gotowa do działania w trybie offline."
"[english]SteamUI_OfflineMode_GameNotReady"	"This game is not ready to be played in Offline Mode."
"SteamUI_OfflineMode_GameNotReady_Title"	"Gra niedostępna"
"[english]SteamUI_OfflineMode_GameNotReady_Title"	"Game unavailable"
"Steam_RunGame_Title_Error"	"Błąd"
"[english]Steam_RunGame_Title_Error"	"Error"
"Steam_RunGame_AnotherGameIsBeingRan"	"Nie można uruchomić gry. W tej chwili trwa uruchamianie kolejnej gry. Poczekaj, aż się zakończy."
"[english]Steam_RunGame_AnotherGameIsBeingRan"	"Cannot run game. You currently have another game launch in progress, please wait until that is complete."
"Steam_RunGame_Title_ConvertingToSteam3Content"	"System plików Steam"
"[english]Steam_RunGame_Title_ConvertingToSteam3Content"	"Steam Content System"
"Steam_RunGame_ConvertingToSteam3Content"	"Ta gra jest przetwarzana na nowy format plików Steam"
"[english]Steam_RunGame_ConvertingToSteam3Content"	"This game is being converted to Steam's new content system"
"Steam_ModNeedsFullGame_Title"	"Błąd"
"[english]Steam_ModNeedsFullGame_Title"	"Error"
"Steam_ModNeedsFullGame_Info"	"{s:game} jest modyfikacją, która wymaga posiadania podstawowej wersji gry."
"[english]Steam_ModNeedsFullGame_Info"	"{s:game} is a mod, and requires you to own a version of the base game."
"Steam_ModNeedsFullGame_Button"	"Więcej informacji"
"[english]Steam_ModNeedsFullGame_Button"	"Get more info"
"Steam_ErrorPurchasePending_Title"	"Oczekujący zakup"
"[english]Steam_ErrorPurchasePending_Title"	"Purchase pending"
"Steam_ErrorPurchasePending_Info"	"Twój zakup wciąż jest przetwarzany - Steam poinformuje cię o ukończeniu transakcji.\nDo tego czasu gra nie jest dostępna."
"[english]Steam_ErrorPurchasePending_Info"	"Your purchase is still being processed - Steam will notify you when the transaction has been completed.\nUntil then, this game is not available to play."
"Steam_Media_GenericFailure"	"Nie udało się dodać medium do listy."
"[english]Steam_Media_GenericFailure"	"Failed to add media to list."
"Steam_Media_ErrorNotEnoughDiskSpace"	"Brak wystarczającej ilości miejsca na dysku do odtworzenia tej zawartości.\nZwolnij miejsce na dysku i spróbuj ponownie."
"[english]Steam_Media_ErrorNotEnoughDiskSpace"	"You do not have enough disk space available to play this media.\nPlease free up some disk space and then try again."
"Steam_SteamErrorTitle"	"Błąd"
"[english]Steam_SteamErrorTitle"	"Error"
"Steam_MediaAdded_Title"	"Sukces"
"[english]Steam_MediaAdded_Title"	"Success"
"Steam_MediaAdded_Info"	"{s:media} został dodany do biblioteki mediów Steam."
"[english]Steam_MediaAdded_Info"	"{s:media} has been added to your Steam media library."
"SteamUI_OfflineMode_Title"	"Tryb offline"
"[english]SteamUI_OfflineMode_Title"	"Offline Mode"
"Steam_CannotInstallInOfflineMode"	"Nie można instalować gier, gdy Steam pracuje w trybie offline.\nZamknij i uruchom ponownie Steam, a następnie wybierz opcję „Przejdź w tryb online”."
"[english]Steam_CannotInstallInOfflineMode"	"Games cannot be installed when Steam is in Offline Mode.\nExit and restart Steam, and choose 'Go Online'.\n"
"Steam_RegionRestricted_Title"	"Gra niedostępna"
"[english]Steam_RegionRestricted_Title"	"Game unavailable"
"Steam_RegionRestrictedPurchase_Info"	"Ta gra została aktywowana kodem produktu ważnym tylko w konkretnym obszarze geograficznym. Ponieważ w tej chwili nie znajdujesz się w tym regionie, {s:game} nie jest dostępne."
"[english]Steam_RegionRestrictedPurchase_Info"	"This game was activated with a product code that is valid only in a specific geographic region. Since you are not currently in that region, {s:game} is not available to play."
"Steam_ErrorNotEnoughDiskSpace_Title"	"Błąd"
"[english]Steam_ErrorNotEnoughDiskSpace_Title"	"Error"
"Steam_ErrorNotEnoughDiskSpace"	"Masz za mało miejsca na dysku, by zainstalować tę grę.\nZwolnij miejsce na dysku i spróbuj ponownie."
"[english]Steam_ErrorNotEnoughDiskSpace"	"You do not have enough disk space available to install this game.\nPlease free up some disk space and then try again."
"Steam_InstallAborted_Title"	"Błąd"
"[english]Steam_InstallAborted_Title"	"Error"
"Steam_InstallAborted_InfoAppNoInfo"	"Nie można zainstalować tej gry."
"[english]Steam_InstallAborted_InfoAppNoInfo"	"This game cannot be installed."
"Steam_InstallAborted_InfoAppUnreleased"	"Nie można jeszcze zainstalować {s:game} - premiera nie miała miejsca."
"[english]Steam_InstallAborted_InfoAppUnreleased"	"{s:game} cannot be installed yet, because it is not yet released."
"Steam_InstallAborted_InfoAppNoDemo"	"Nie można zainstalować{s:game}, gdyż jest to demo, a ty posiadasz pełną wersję tego produktu. Zainstaluj pełną wersję gry."
"[english]Steam_InstallAborted_InfoAppNoDemo"	"{s:game} cannot be installed, because it is a demo, and you own the full version of the product. Please install the full version of the game."
"Steam_NoContentServers_Info"	"Żaden z serwerów zawartości Steam nie jest obecnie skonfigurowany, aby dostarczyć zawartość tej gry.\nTo zostanie wkrótce naprawione. Spróbuj ponownie za kilka minut."
"[english]Steam_NoContentServers_Info"	"No Steam content servers are currently configured to deliver content for this game.\nThis will be corrected soon. Please try again in a few minutes."
"Steam_App_Install_Failed_Title"	"Błąd"
"[english]Steam_App_Install_Failed_Title"	"Error"
"Steam_App_Install_Failed_Text"	"Podczas instalacji {s:game} wystąpił błąd ({s:reason})."
"[english]Steam_App_Install_Failed_Text"	"An error occurred while installing {s:game} ({s:reason})"
"Steam_App_Update_Failed_Title"	"Błąd"
"[english]Steam_App_Update_Failed_Title"	"Error"
"Steam_App_Update_Failed_Text"	"Podczas aktualizacji {s:game} wystąpił błąd ({s:reason})."
"[english]Steam_App_Update_Failed_Text"	"An error occurred while updating {s:game} ({s:reason})."
"SteamUI_JoinDialog_DataRequestFailed_Title"	"Błąd"
"[english]SteamUI_JoinDialog_DataRequestFailed_Title"	"Error"
"SteamUI_JoinDialog_DataRequestFailed_Text"	"Serwery Steam są w tej chwili zbyt zajęte, by zająć się twoją sprawą dla {s:game}. Kod błędu: ({d:error})."
"[english]SteamUI_JoinDialog_DataRequestFailed_Text"	"The Steam servers are too busy to handle your request for {s:game}. Error Code ({d:error})."
"SteamUI_JoinDialog_KeyRequestFailed_Title"	"Błąd"
"[english]SteamUI_JoinDialog_KeyRequestFailed_Title"	"Error"
"SteamUI_JoinDialog_KeyRequestFailed_Text"	"Nie można nawiązać połączenia z serwerem kluczy"
"[english]SteamUI_JoinDialog_KeyRequestFailed_Text"	"Failed to contact key server"
"SteamUI_JoinDialog_KeyRequestPending_Title"	"Błąd"
"[english]SteamUI_JoinDialog_KeyRequestPending_Title"	"Error"
"SteamUI_JoinDialog_KeyRequestPending_Text"	"Oczekująca prośba o klucz"
"[english]SteamUI_JoinDialog_KeyRequestPending_Text"	"Key request pending"
"Steam_NoLongerOwnsGame_Title"	"Błąd"
"[english]Steam_NoLongerOwnsGame_Title"	"Error"
"Steam_NoLongerOwnsGame_Info"	"Produkt {s:game} nie jest już dostępny za darmo."
"[english]Steam_NoLongerOwnsGame_Info"	"{s:game} is no longer available for free."
"Steam_UnknownErrorLaunchingMedia"	"Nieznany błąd przy uruchamianiu mediów."
"[english]Steam_UnknownErrorLaunchingMedia"	"Unknown error launching media."
"SteamUI_JoinDialog_ErrorTitle"	"Błąd"
"[english]SteamUI_JoinDialog_ErrorTitle"	"Error"
"SteamUI_CantRunMediaDueToMediaPlayerVersion"	"Nie można uruchomić {s:game}, ponieważ Windows Media Player jest w wersji [{s:detectedVersion}], a wymagana jest wersja [{s:requiredVersion}].\nZainstaluj najnowszą wersję Windows Media Player."
"[english]SteamUI_CantRunMediaDueToMediaPlayerVersion"	"Can't launch {s:game} because Windows Media Player is version [{s:detectedVersion}], but version [{s:requiredVersion}] is required to play the media.\nPlease install the latest version of Windows Media Player."
"SteamUI_CantRunMediaDueToMediaPlayerNotInstalled"	"Nie można uruchomić {s:game}, ponieważ Windows Media Player nie jest zainstalowany.\nZainstaluj najnowszą wersję Windows Media Player z"
"[english]SteamUI_CantRunMediaDueToMediaPlayerNotInstalled"	"Can't launch {s:game} because Windows Media Player is not installed.\nPlease install the latest version of Windows Media Player from"
"SteamUI_CantRunMediaDueToMediaPlayerNotInstalledOSX"	"Nie można uruchomić {s:game}, ponieważ składniki pakietu Windows Media dla QuickTime nie są zainstalowane.\nZainstaluj najnowszą wersję składników pakietu Windows Media dla QuickTime."
"[english]SteamUI_CantRunMediaDueToMediaPlayerNotInstalledOSX"	"Can't launch {s:game} because Windows Media Components for QuickTime are not installed.\nPlease install the latest version of Windows Media Components for QuickTime."
"Steam_ErrorCantStartGame"	"Gra jest obecnie niedostępna.\nSpróbuj ponownie później."
"[english]Steam_ErrorCantStartGame"	"This game is currently unavailable.\nPlease try again at another time."
"Steam_ErrorCantStartGame2"	"Gra jest obecnie niedostępna ({s:error})."
"[english]Steam_ErrorCantStartGame2"	"This game is currently unavailable ( {s:error} )."
"Steam_ContentServersBusy_Title"	"Błąd"
"[english]Steam_ContentServersBusy_Title"	"Error"
"Steam_ContentServersBusy_Info"	"Serwery Steam są w tej chwili zbyt zajęte, by zająć się twoją sprawą.\nSpróbuj ponownie za kilka minut."
"[english]Steam_ContentServersBusy_Info"	"The Steam servers are currently too busy to handle your request.\nPlease try again in a few minutes."
"SteamUI_JoinDialog_PreparingToPlay1"	"Przygotowanie do uruchomienia {s:game}."
"[english]SteamUI_JoinDialog_PreparingToPlay1"	"Preparing to launch {s:game}."
"SteamUI_JoinDialog_PreparingToPlay2"	"Przygotowanie do uruchomienia {s:game}.."
"[english]SteamUI_JoinDialog_PreparingToPlay2"	"Preparing to launch {s:game}.."
"SteamUI_JoinDialog_PreparingToPlay3"	"Przygotowanie do uruchomienia {s:game}..."
"[english]SteamUI_JoinDialog_PreparingToPlay3"	"Preparing to launch {s:game}..."
"Friends_Tab_Friends"	"ZNAJOMI"
"[english]Friends_Tab_Friends"	"FRIENDS"
"Friends_Tab_Groups"	"GRUPY"
"[english]Friends_Tab_Groups"	"GROUPS"
"Friends_Tab_Players"	"GRACZE"
"[english]Friends_Tab_Players"	"PLAYERS"
"Friends_ChatWith_X"	"Czat z\n{s:chatfriendname}"
"[english]Friends_ChatWith_X"	"Chat with\n{s:chatfriendname}"
"Friends_GroupChatWith_X"	"Czat grupowy z\n{s:chatfriendname}"
"[english]Friends_GroupChatWith_X"	"Group chat with\n{s:chatfriendname}"
"Friends_Chat_StartVoiceChat"	"ROZPOCZNIJ CZAT GŁOSOWY"
"[english]Friends_Chat_StartVoiceChat"	"START VOICE CHAT"
"Friends_Chat_AcceptVoiceChat"	"ZAAKCEPTUJ CZAT GŁOSOWY"
"[english]Friends_Chat_AcceptVoiceChat"	"ACCEPT VOICE CHAT"
"Friends_Chat_DeclineVoiceChat"	"ODRZUĆ CZAT GŁOSOWY"
"[english]Friends_Chat_DeclineVoiceChat"	"DECLINE VOICE CHAT"
"Friends_Chat_HoldVoiceChat"	"WSTRZYMAJ CZAT GŁOSOWY"
"[english]Friends_Chat_HoldVoiceChat"	"HOLD VOICE CHAT"
"Friends_Chat_ResumeVoiceChat"	"WZNÓW CZAT GŁOSOWY"
"[english]Friends_Chat_ResumeVoiceChat"	"RESUME VOICE CHAT"
"Friends_Chat_EndVoiceChat"	"ZAKOŃCZ CZAT GŁOSOWY"
"[english]Friends_Chat_EndVoiceChat"	"END VOICE CHAT"
"Friends_Chat_X_IsTyping"	"{s:chatfriendname} pisze wiadomość..."
"[english]Friends_Chat_X_IsTyping"	"{s:chatfriendname} is typing..."
"Friends_Chat_LastMessage"	"Ostatnia odebrana wiadomość: {t:t:chatlastmsgtime}"
"[english]Friends_Chat_LastMessage"	"Last message {t:t:chatlastmsgtime}"
"Friends_Chat_Send"	"WYŚLIJ"
"[english]Friends_Chat_Send"	"SEND"
"Friends_Chat_Join"	"DOŁĄCZ"
"[english]Friends_Chat_Join"	"JOIN"
"Friends_DontGiveOutPassword"	"Nigdy nie zdradzaj nikomu swojego hasła."
"[english]Friends_DontGiveOutPassword"	"Never tell your password to anyone."
"Friends_Indicator_Chat"	"Czat"
"[english]Friends_Indicator_Chat"	"Chat"
"Friends_Indicator_VoiceChat"	"Czat głosowy"
"[english]Friends_Indicator_VoiceChat"	"Voice Chat"
"Friends_Indicator_VoiceChatDialing"	"Wybieranie..."
"[english]Friends_Indicator_VoiceChatDialing"	"Dialing..."
"Friends_Indicator_VoiceChatRinging"	"Prośba o czat głosowy"
"[english]Friends_Indicator_VoiceChatRinging"	"Voice Chat Request"
"Friends_Indicator_VoiceChatOnHold"	"Czat głosowy wstrzymany"
"[english]Friends_Indicator_VoiceChatOnHold"	"Voice Chat On Hold"
"Friends_Indicator_GameInvite"	"Zaproszenie do gry"
"[english]Friends_Indicator_GameInvite"	"Game Invite"
"Friends_Indicator_FriendRequest"	"Zaproszenie do znajomych"
"[english]Friends_Indicator_FriendRequest"	"Friend Request"
"Friends_Footer_More"	"WIĘCEJ"
"[english]Friends_Footer_More"	"MORE"
"Friends_Footer_SendMessage"	"CZAT"
"[english]Friends_Footer_SendMessage"	"CHAT"
"Friends_Footer_JoinGroupChat"	"DOŁĄCZ DO CZATU"
"[english]Friends_Footer_JoinGroupChat"	"JOIN CHAT"
"Friends_Footer_LeaveGroupChat"	"OPUŚĆ CZAT"
"[english]Friends_Footer_LeaveGroupChat"	"LEAVE CHAT"
"Friends_ProfileDetails_Action_SendMessage"	"Wyślij wiadomość"
"[english]Friends_ProfileDetails_Action_SendMessage"	"Send Message"
"Friends_ProfileDetails_Action_VoiceChatStart"	"Rozpocznij czat głosowy"
"[english]Friends_ProfileDetails_Action_VoiceChatStart"	"Start Voice Chat"
"Friends_ProfileDetails_Action_VoiceChatAccept"	"Zaakceptuj czat głosowy"
"[english]Friends_ProfileDetails_Action_VoiceChatAccept"	"Accept Voice Chat"
"Friends_ProfileDetails_Action_VoiceChatReject"	"Odrzuć czat głosowy"
"[english]Friends_ProfileDetails_Action_VoiceChatReject"	"Decline Voice Chat"
"Friends_ProfileDetails_Action_VoiceChatHold"	"Wstrzymaj czat głosowy"
"[english]Friends_ProfileDetails_Action_VoiceChatHold"	"Hold Voice Chat"
"Friends_ProfileDetails_Action_VoiceChatResume"	"Wznów czat głosowy"
"[english]Friends_ProfileDetails_Action_VoiceChatResume"	"Resume Voice Chat"
"Friends_ProfileDetails_Action_VoiceChatEnd"	"Zakończ rozmowę głosową"
"[english]Friends_ProfileDetails_Action_VoiceChatEnd"	"End Voice Chat"
"Friends_ProfileDetails_Action_JoinGroupChat"	"Dołącz do rozmowy grupowej"
"[english]Friends_ProfileDetails_Action_JoinGroupChat"	"Join Group Chat"
"Friends_ProfileDetails_Action_LeaveGroupChat"	"Opuść rozmowę grupową"
"[english]Friends_ProfileDetails_Action_LeaveGroupChat"	"Leave Group Chat"
"Friends_ProfileDetails_Action_LeaveGroup"	"Opuść grupę"
"[english]Friends_ProfileDetails_Action_LeaveGroup"	"Leave Group"
"Friends_ProfileDetails_ViewSteamProfile"	"Wyświetl profil Steam"
"[english]Friends_ProfileDetails_ViewSteamProfile"	"View Steam Profile"
"Friends_ProfileDetails_Action_LaunchGame"	"Uruchom {s:gamename}"
"[english]Friends_ProfileDetails_Action_LaunchGame"	"Launch {s:gamename}"
"Friends_ProfileDetails_Action_InviteToGroup"	"Zaproś do grupy"
"[english]Friends_ProfileDetails_Action_InviteToGroup"	"Invite to Group"
"Friends_ProfileDetails_Action_InviteToTrade"	"Zaproś do wymiany"
"[english]Friends_ProfileDetails_Action_InviteToTrade"	"Invite to Trade"
"Friends_ProfileDetails_Action_TagAs"	"Otaguj jako..."
"[english]Friends_ProfileDetails_Action_TagAs"	"Tag as..."
"Friends_ProfileDetails_Action_ViewAliases"	"Wyświetl pseudonimy"
"[english]Friends_ProfileDetails_Action_ViewAliases"	"View Aliases"
"Friends_ProfileDetails_Action_BlockAllCommunication"	"Zablokuj wszelką komunikację"
"[english]Friends_ProfileDetails_Action_BlockAllCommunication"	"Block All Communication"
"Friends_ProfileDetails_Action_RemoveFriend"	"Usuń znajomego"
"[english]Friends_ProfileDetails_Action_RemoveFriend"	"Remove Friend"
"Friends_ClanStatus_Chat1_Game1_Online1"	"{i:numfriendsinchat} na czacie, {i:numfriendsingame} w grze, {i:numfriendsonline} online"
"[english]Friends_ClanStatus_Chat1_Game1_Online1"	"{i:numfriendsinchat} In Chat, {i:numfriendsingame} In-Game, {i:numfriendsonline} Online"
"Friends_ClanStatus_Chat1_Game1_Online0"	"{i:numfriendsinchat} na czacie, {i:numfriendsingame} w grze"
"[english]Friends_ClanStatus_Chat1_Game1_Online0"	"{i:numfriendsinchat} In Chat, {i:numfriendsingame} In-Game"
"Friends_ClanStatus_Chat1_Game0_Online1"	"{i:numfriendsinchat} na czacie, {i:numfriendsingame} w grze"
"[english]Friends_ClanStatus_Chat1_Game0_Online1"	"{i:numfriendsinchat} In Chat, {i:numfriendsonline} Online"
"Friends_ClanStatus_Chat1_Game0_Online0"	"{i:numfriendsinchat} na czacie"
"[english]Friends_ClanStatus_Chat1_Game0_Online0"	"{i:numfriendsinchat} In Chat"
"Friends_ClanStatus_Chat0_Game1_Online1"	"{i:numfriendsinchat} w grze, {i:numfriendsingame} online"
"[english]Friends_ClanStatus_Chat0_Game1_Online1"	"{i:numfriendsingame} In-Game, {i:numfriendsonline} Online"
"Friends_ClanStatus_Chat0_Game1_Online0"	"{i:numfriendsingame} w grze"
"[english]Friends_ClanStatus_Chat0_Game1_Online0"	"{i:numfriendsingame} In-Game"
"Friends_ClanStatus_Chat0_Game0_Online1"	"{i:numfriendsonline} online"
"[english]Friends_ClanStatus_Chat0_Game0_Online1"	"{i:numfriendsonline} Online"
"Friends_ClanStatus_Chat0_Game0_Online0"	" "
"[english]Friends_ClanStatus_Chat0_Game0_Online0"	""
"Friends_AddFriend"	"DODAJ ZNAJOMEGO"
"[english]Friends_AddFriend"	"ADD FRIEND"
"Friends_AddFriendTitle"	"Dodaj znajomego"
"[english]Friends_AddFriendTitle"	"Add a Friend"
"Friends_AddFriendDesc"	"Wprowadź nazwę gracza, nazwę konta, prawdziwe imię i nazwisko, adres e-mail lub adres URL profilu osoby, której szukasz."
"[english]Friends_AddFriendDesc"	"Enter the player name, account name, real name, email address or profile URL name of the person you're looking for."
"Friends_AddFriend_OK"	"OK"
"[english]Friends_AddFriend_OK"	"OK"
"Friends_AddFriend_Cancel"	"ANULUJ"
"[english]Friends_AddFriend_Cancel"	"CANCEL"
"Friends_RemoveFriend_Title"	"Usuń znajomego"
"[english]Friends_RemoveFriend_Title"	"Remove Friend"
"Friends_RemoveFriend_Body"	"Czy na pewno chcesz usunąć znajomego {s:personaname}{s:nickname}?\n\n(Możesz dodać go ponownie za pomocą funkcji Dodaj znajomego)"
"[english]Friends_RemoveFriend_Body"	"Are you sure you want to remove {s:personaname}{s:nickname} as a friend?\n\n(You can add them again later using Add Friend.)"
"Friends_RemoveFriend_OkButton"	"USUŃ"
"[english]Friends_RemoveFriend_OkButton"	"REMOVE"
"Friends_ProfileDetails_Action_JoinGame"	"Dołącz do gry"
"[english]Friends_ProfileDetails_Action_JoinGame"	"Join Game"
"Friends_ProfileDetails_Action_IgnoreJoinGame"	"Odrzuć zaproszenie do gry"
"[english]Friends_ProfileDetails_Action_IgnoreJoinGame"	"Ignore Game Invite"
"Friends_ProfileDetails_Action_AcceptFriendship"	"Zaakceptuj zaproszenie do znajomych"
"[english]Friends_ProfileDetails_Action_AcceptFriendship"	"Accept Friend Invite"
"Friends_ProfileDetails_Action_IgnoreFriendship"	"Zignoruj zaproszenie do znajomych"
"[english]Friends_ProfileDetails_Action_IgnoreFriendship"	"Ignore Friend Invite"
"Friends_ProfileDetails_Action_BlockFriendship"	"Zablokuj zaproszenia do znajomych"
"[english]Friends_ProfileDetails_Action_BlockFriendship"	"Block Friend Invites"
"Community_Friends_InGame_Count"	"ZNAJOMYCH W GRZE: {i:numfriendsingame}"
"[english]Community_Friends_InGame_Count"	"{i:numfriendsingame} FRIENDS IN-GAME"
"Community_Friends_MoreOnline_Count"	"JESZCZE {i:numfriendsonline} ONLINE"
"[english]Community_Friends_MoreOnline_Count"	"{i:numfriendsonline} MORE ONLINE"
"Community_Friends_JustOnline_Count"	"ZNAJOMI ONLINE: {i:numfriendsonline}"
"[english]Community_Friends_JustOnline_Count"	"{i:numfriendsonline} FRIENDS ONLINE"
"Community_Friends_Offline_Count"	"ZNAJOMI: {i:numfriendsoffline}"
"[english]Community_Friends_Offline_Count"	"{i:numfriendsoffline} FRIENDS"
"Community_Friends_ActivityFeed"	"DZIENNIK AKTYWNOŚCI"
"[english]Community_Friends_ActivityFeed"	"ACTIVITY FEED"
"Friends_Chat_Fail_LocalUserOffline"	"Nie można wysłać wiadomości, bo jesteś offline."
"[english]Friends_Chat_Fail_LocalUserOffline"	"Cannot send message because you are offline."
"Friends_Chat_Fail_FriendUserOffline"	"Nie można wysłać wiadomości, bo użytkownik jest offline."
"[english]Friends_Chat_Fail_FriendUserOffline"	"Cannot send message, user is offline."
"Friends_UsersInVoiceChat_NoOthers"	"NIKT INNY NIE\nCZATUJE GŁOSOWO"
"[english]Friends_UsersInVoiceChat_NoOthers"	"NO OTHER PEOPLE\nVOICE CHATTING"
"Friends_UsersInVoiceChat_OneOther"	"1 INNA OSOBA\nCZATUJE GŁOSOWO"
"[english]Friends_UsersInVoiceChat_OneOther"	"1 OTHER PERSON\nVOICE CHATTING"
"Friends_UsersInVoiceChat_ManyOthers"	"{i:UsersInVoiceChat} INNYCH OSÓB\nCZATUJE GŁOSOWO"
"[english]Friends_UsersInVoiceChat_ManyOthers"	"{i:UsersInVoiceChat} OTHER PEOPLE\nVOICE CHATTING"
"Friends_UsersInVoiceChat_Dialing"	"WYBIERANIE..."
"[english]Friends_UsersInVoiceChat_Dialing"	"DIALING..."
"Friends_UsersInVoiceChat_Ringing"	"PROŚBA O CZAT GŁOSOWY"
"[english]Friends_UsersInVoiceChat_Ringing"	"VOICE CHAT REQUEST"
"Friends_UsersInVoiceChat_Waiting"	"CZAT GŁOSOWY\nWSTRZYMANY"
"[english]Friends_UsersInVoiceChat_Waiting"	"VOICE CHAT\nON HOLD"
"Friends_UsersInVoiceChat_LocalHold"	"WSTRZYMANO TEN\nCZAT GŁOSOWY"
"[english]Friends_UsersInVoiceChat_LocalHold"	"YOU HAVE PUT THIS\nVOICE CHAT ON HOLD"
"Friends_UsersInVoiceChat_RemoteHold"	"TWÓJ ZNAJOMY WSTRZYMAŁ\nTEN CZAT GŁOSOWY"
"[english]Friends_UsersInVoiceChat_RemoteHold"	"YOUR FRIEND PUT THIS\nVOICE CHAT ON HOLD"
"Friends_UsersInVoiceChat_InCall"	"CZAT GŁOSOWY\nW TOKU"
"[english]Friends_UsersInVoiceChat_InCall"	"VOICE CHAT\nIN PROGRESS"
"Community_Friends_ActivityFeed_ViewSteamProfile"	"Wyświetl profil Steam"
"[english]Community_Friends_ActivityFeed_ViewSteamProfile"	"View Steam Profile"
"Community_Friends_ActivityFeed_MoreOnA"	"Więcej na {s:subject_a}"
"[english]Community_Friends_ActivityFeed_MoreOnA"	"More on {s:subject_a}"
"Community_Friends_ActivityFeed_ViewFriendsListA"	"Wyświetl listę znajomych użytkownika {s:subject_a}"
"[english]Community_Friends_ActivityFeed_ViewFriendsListA"	"View {s:subject_a}'s Friends List"
"Community_Friends_ActivityFeed_ViewGroupsListA"	"Wyświetl grupy użytkownika {s:subject_a}"
"[english]Community_Friends_ActivityFeed_ViewGroupsListA"	"View {s:subject_a}'s Groups List"
"Community_Friends_ActivityFeed_ViewWishListA"	"Wyświetl listę życzeń użytkownika {s:subject_a}"
"[english]Community_Friends_ActivityFeed_ViewWishListA"	"View {s:subject_a}'s Wishlist"
"Community_Friends_ActivityFeed_ViewGameStore"	"Wyświetl stronę gry w sklepie"
"[english]Community_Friends_ActivityFeed_ViewGameStore"	"View Game Store Page"
"Community_Friends_ActivityFeed_ViewGameHub"	"Wyświetl centrum gry"
"[english]Community_Friends_ActivityFeed_ViewGameHub"	"View Game Hub"
"Community_Friends_ActivityFeed_ViewGroupProfile"	"Wyświetl profil grupy"
"[english]Community_Friends_ActivityFeed_ViewGroupProfile"	"View Group's Steam Profile"
"Community_Friends_ActivityFeed_ViewRecommendation"	"Zobacz rekomendacje"
"[english]Community_Friends_ActivityFeed_ViewRecommendation"	"View Recommendation"
"Community_Friends_ActivityFeed_ViewScreenshot"	"Wyświetl zrzut ekranu"
"[english]Community_Friends_ActivityFeed_ViewScreenshot"	"View Screenshot"
"Community_Friends_ActivityFeed_ViewScreenshots"	"Wyświetl zrzuty ekranu"
"[english]Community_Friends_ActivityFeed_ViewScreenshots"	"View Screenshots"
"Community_Friends_ActivityFeed_ViewVideo"	"Obejrzyj film"
"[english]Community_Friends_ActivityFeed_ViewVideo"	"Watch Video"
"Community_Friends_ActivityFeed_ViewVideos"	"Obejrzyj filmy"
"[english]Community_Friends_ActivityFeed_ViewVideos"	"Watch Videos"
"Community_Friends_ActivityFeed_ViewAnnouncement"	"Zobacz ogłoszenie"
"[english]Community_Friends_ActivityFeed_ViewAnnouncement"	"View Announcement"
"Community_Friends_ActivityFeed_ViewEventDetails"	"Pokaż szczegóły wydarzenia"
"[english]Community_Friends_ActivityFeed_ViewEventDetails"	"View Event Details"
"10ft_Friends_online"	"Online"
"[english]10ft_Friends_online"	"Online"
"10ft_Friends_away"	"Zaraz wracam"
"[english]10ft_Friends_away"	"Away"
"10ft_Friends_busy"	"Zajęty"
"[english]10ft_Friends_busy"	"Busy"
"10ft_Friends_snooze"	"Drzemka"
"[english]10ft_Friends_snooze"	"Snooze"
"10ft_Friends_offline"	"Offline"
"[english]10ft_Friends_offline"	"Offline"
"10ft_Friends_lookingtotrade"	"Chcę się wymienić"
"[english]10ft_Friends_lookingtotrade"	"Looking to Trade"
"10ft_Friends_lookingtoplay"	"Chcę pograć"
"[english]10ft_Friends_lookingtoplay"	"Looking to Play"
"10ft_Friends_mobile_device_only"	"{s:personastate} na urządzeniu mobilnym"
"[english]10ft_Friends_mobile_device_only"	"{s:personastate} on Mobile Device"
"10ft_Friends_mobile_device_extra"	"{s:personastate}, także mobilnie"
"[english]10ft_Friends_mobile_device_extra"	"{s:personastate}, Mobile"
"10ft_Friends_InGame"	"W grze"
"[english]10ft_Friends_InGame"	"In-Game"
"10ft_Friends_InMod"	"W modyfikacji"
"[english]10ft_Friends_InMod"	"In-Mod"
"10ft_Friends_InShortcut"	"W grze spoza Steam"
"[english]10ft_Friends_InShortcut"	"In non-Steam game"
"Gamepad_DPad"	"KRZYŻAK"
"[english]Gamepad_DPad"	"DPAD"
"Gamepad_Up"	"GÓRA"
"[english]Gamepad_Up"	"UP"
"Gamepad_Down"	"DÓŁ"
"[english]Gamepad_Down"	"DOWN"
"Gamepad_Left"	"LEWO"
"[english]Gamepad_Left"	"LEFT"
"Gamepad_Right"	"PRAWO"
"[english]Gamepad_Right"	"RIGHT"
"Gamepad_Start"	"START"
"[english]Gamepad_Start"	"START"
"Gamepad_Back"	"BACK"
"[english]Gamepad_Back"	"BACK"
"Gamepad_Stick1"	"Lewa gałka"
"[english]Gamepad_Stick1"	"LS"
"Gamepad_Stick2"	"Prawa gałka"
"[english]Gamepad_Stick2"	"RS"
"Gamepad_A"	"A"
"[english]Gamepad_A"	"A"
"Gamepad_B"	"B"
"[english]Gamepad_B"	"B"
"Gamepad_X"	"X"
"[english]Gamepad_X"	"X"
"Gamepad_Y"	"Y"
"[english]Gamepad_Y"	"Y"
"Gamepad_LB"	"LB"
"[english]Gamepad_LB"	"LB"
"Gamepad_RB"	"RB"
"[english]Gamepad_RB"	"RB"
"Gamepad_LT"	"LT"
"[english]Gamepad_LT"	"LT"
"Gamepad_RT"	"RT"
"[english]Gamepad_RT"	"RT"
"Gamepad_LStick"	"LS"
"[english]Gamepad_LStick"	"LS"
"Gamepad_RStick"	"RS"
"[english]Gamepad_RStick"	"RS"
"Gamepad_Guide"	"Główna"
"[english]Gamepad_Guide"	"Home"
"Web_Favorite_Name"	"Nazwa ulubionej"
"[english]Web_Favorite_Name"	"Favorite Name"
"Web_Back"	"Wstecz"
"[english]Web_Back"	"Back"
"Web_Forward"	"Dalej"
"[english]Web_Forward"	"Forward"
"Web_AddFavorite"	"Dodaj do ulubionych"
"[english]Web_AddFavorite"	"Add To Favorites"
"Web_Top"	"Na górę"
"[english]Web_Top"	"Top"
"Web_Add"	"Dodaj"
"[english]Web_Add"	"Add"
"Web_WebBrowser"	"ODWIEDŹ SIEĆ"
"[english]Web_WebBrowser"	"GO TO WEB"
"Web_Favorite"	"ULUBIONE"
"[english]Web_Favorite"	"FAVORITES"
"Web_ZoomCaps"	"POWIĘKSZENIE"
"[english]Web_ZoomCaps"	"ZOOM"
"Web_Zoom"	"Powiększenie"
"[english]Web_Zoom"	"Zoom"
"Web_Select"	"WYBIERZ"
"[english]Web_Select"	"SELECT"
"Web_NewTabCaps"	"NOWA KARTA"
"[english]Web_NewTabCaps"	"NEW TAB"
"Web_UrlEdit"	"WIĘCEJ"
"[english]Web_UrlEdit"	"MORE"
"Web_MoveTab"	"KARTY"
"[english]Web_MoveTab"	"TABS"
"Web_UrlGo"	"PRZEJDŹ"
"[english]Web_UrlGo"	"GO"
"Web_Reload"	"Odśwież"
"[english]Web_Reload"	"Reload"
"Web_CloseTab"	"Zamknij kartę"
"[english]Web_CloseTab"	"Close Tab"
"Web_CloseTabCaps"	"ZAMKNIJ KARTĘ"
"[english]Web_CloseTabCaps"	"CLOSE TAB"
"Web_Edit"	"Zmień URL lub wyszukaj"
"[english]Web_Edit"	"Edit URL or Search"
"Web_Frequent"	"HISTORIA"
"[english]Web_Frequent"	"HISTORY"
"Web_Current"	"OBECNE"
"[english]Web_Current"	"CURRENT"
"Web_AddTab"	"Nowa karta"
"[english]Web_AddTab"	"New Tab"
"Web_EmptyTab"	"Pusta karta"
"[english]Web_EmptyTab"	"Empty Tab"
"Web_DeleteHistory_Title"	"WYCZYŚĆ HISTORIĘ"
"[english]Web_DeleteHistory_Title"	"DELETE HISTORY"
"Web_DeleteHistory_Text"	"Na pewno chcesz wyczyścić całą historię przeglądania?"
"[english]Web_DeleteHistory_Text"	"Do you want to clear all your browsing history?"
"Web_ClearHistory"	"WYCZYŚĆ HISTORIĘ"
"[english]Web_ClearHistory"	"CLEAR HISTORY"
"Web_DeleteFavorite"	"USUŃ Z ULUBIONYCH"
"[english]Web_DeleteFavorite"	"DELETE FAVORITE"
"Web_CopyURL"	"Skopiuj URL do schowka"
"[english]Web_CopyURL"	"Copy URL to Clipboard"
"Web_DeleteFavorite_Title"	"USUŃ Z ULUBIONYCH"
"[english]Web_DeleteFavorite_Title"	"DELETE FAVORITE"
"Web_DeleteFavorite_Text"	"Czy chcesz usunąć tę kartę z ulubionych?"
"[english]Web_DeleteFavorite_Text"	"Do you want to delete this favorite?"
"Web_RecentLabel"	"OSTATNIE"
"[english]Web_RecentLabel"	"RECENT"
"Web_FrequentLabel"	"CZĘSTO ODWIEDZANE"
"[english]Web_FrequentLabel"	"FREQUENT"
"Web_OpenInNewTab"	"Otwórz w nowej karcie"
"[english]Web_OpenInNewTab"	"Open in new tab"
"Web_FullScreen_Exit"	"WYJDŹ Z TRYBU PEŁNOEKRANOWEGO"
"[english]Web_FullScreen_Exit"	"EXIT FULLSCREEN"
"Web_FullScreen_PlayPause"	"GRAJ/ZAPAUZUJ"
"[english]Web_FullScreen_PlayPause"	"PLAY/PAUSE"
"Web_FormSubmit"	"WYŚLIJ"
"[english]Web_FormSubmit"	"SUBMIT"
"WebBrowser_Next"	"DALEJ"
"[english]WebBrowser_Next"	"NEXT"
"cef_error_title"	"Błąd"
"[english]cef_error_title"	"Error"
"cef_error_header"	"Kod błędu"
"[english]cef_error_header"	"Error Code"
"cef_cachemiss"	"Żądanie twojego formularza wygasło. Kliknij przycisk „Odśwież”, aby wysłać ponownie dane formularza."
"[english]cef_cachemiss"	"Your form request has expired. Click reload to re-submit the form data."
"cef_badurl"	"Nie można załadować strony, nieprawidłowa nazwa hosta lub format"
"[english]cef_badurl"	"Unable to load URL, bad hostname or format"
"cef_connectionproblem"	"Nie można połączyć się z serwerem. Serwer może być wyłączony lub możesz nie mieć dostępu do Internetu."
"[english]cef_connectionproblem"	"Unable to connect to server. Server may be offline or you may not be connected to the internet."
"cef_proxyconnectionproblem"	"Nie można połączyć się z proxy HTTP. Twój serwer proxy może być nieprawidłowo skonfigurowany lub wyłączony."
"[english]cef_proxyconnectionproblem"	"Unable to connect to HTTP Proxy. Your proxy may be misconfigured or offline."
"cef_unknown"	"Nie można załadować strony sieci web (nieznany błąd)."
"[english]cef_unknown"	"Failed to load web page (unknown error)."
"Movie_Playing"	"Ogląda"
"[english]Movie_Playing"	"Playing"
"Movie_FastFoward"	"{i:playback_speed}x prędkość przewijania"
"[english]Movie_FastFoward"	"{i:playback_speed}x fast-forward"
"Movie_Rewind"	"{i:playback_speed}x prędkość cofania"
"[english]Movie_Rewind"	"{i:playback_speed}x rewind"
"Downloads_Title"	"Elementy pobrane"
"[english]Downloads_Title"	"Downloads"
"Downloads_Amount"	"- pobieranie"
"[english]Downloads_Amount"	"Downloading"
"Downloads_TimeRemain"	"Pozostały czas"
"[english]Downloads_TimeRemain"	"Time remaining"
"Downloads_CurrentRate"	"OBECNA PRĘDKOŚĆ"
"[english]Downloads_CurrentRate"	"CURRENT RATE"
"Downloads_CurrentRate2"	"Obecna prędkość"
"[english]Downloads_CurrentRate2"	"Current rate"
"Downloads_PeakRate"	"NAJWYŻSZA PRĘDKOŚĆ"
"[english]Downloads_PeakRate"	"PEAK RATE"
"Downloads_TotalDownload"	"RAZEM"
"[english]Downloads_TotalDownload"	"TOTAL"
"Downloads_Pause"	"PAUZA"
"[english]Downloads_Pause"	"PAUSE"
"Downloads_Resume"	"WZNÓW"
"[english]Downloads_Resume"	"RESUME"
"Downloads_PauseAll"	"WSTRZYMAJ WSZYSTKO"
"[english]Downloads_PauseAll"	"PAUSE ALL"
"Downloads_ResumeAll"	"WZNÓW WSZYSTKO"
"[english]Downloads_ResumeAll"	"RESUME ALL"
"Downloads_ViewInLibrary"	"ZOBACZ W BIBLIOTECE"
"[english]Downloads_ViewInLibrary"	"VIEW IN LIBRARY"
"Downloads_Remove"	"ODRZUĆ"
"[english]Downloads_Remove"	"DISMISS"
"Downloads_Finished"	"Zakończono pobieranie o {t:t:downloadfinished}"
"[english]Downloads_Finished"	"Download finished at {t:t:downloadfinished}"
"Downloads_AmountValue"	"{s:downloadamount}"
"[english]Downloads_AmountValue"	"{s:downloadamount}"
"Downloads_TimeRemainValue"	"{t:r:downloadtime}"
"[english]Downloads_TimeRemainValue"	"{t:r:downloadtime}"
"Downloads_CurrentRateValue"	"{s:downloadrate}/s"
"[english]Downloads_CurrentRateValue"	"{s:downloadrate}/s"
"Downloads_Percent"	"{s:downloadpercent}"
"[english]Downloads_Percent"	"{s:downloadpercent}"
"Downloads_ItemsDownloading"	"POBIERANYCH ELEMENTÓW: {i:downloadcount}"
"[english]Downloads_ItemsDownloading"	"{i:downloadcount} ITEMS DOWNLOADING"
"Downloads_ItemsPaused"	"WSTRZYMANYCH ELEMENTÓW: {i:downloadpaused}"
"[english]Downloads_ItemsPaused"	"{i:downloadpaused} ITEMS PAUSED"
"Downloads_TotalAmountValue"	"{s:downloadamount}"
"[english]Downloads_TotalAmountValue"	"{s:downloadamount}"
"Downloads_PeakRateValue"	"{s:downloadpeakrate}/s"
"[english]Downloads_PeakRateValue"	"{s:downloadpeakrate}/s"
"UI_Done"	"GOTOWE"
"[english]UI_Done"	"DONE"
"Settings_ComingSoon"	"Ta funkcja nie jest jeszcze dostępna, ale będzie wkrótce!"
"[english]Settings_ComingSoon"	"This feature is not ready yet, but it will be coming soon!"
"Store_PackagePurchaseSection_IndividualPrice"	"Koszt przy zakupie gier osobno"
"[english]Store_PackagePurchaseSection_IndividualPrice"	"Price of individual games"
"Store_PackagePurchaseSection_Bundle"	"Koszt pakietu"
"[english]Store_PackagePurchaseSection_Bundle"	"Bundle cost"
"Store_PackagePurchaseSection_BundleSavings"	"Kupując ten pakiet oszczędzisz"
"[english]Store_PackagePurchaseSection_BundleSavings"	"With this bundle you save"
"Checkout_Review_ViewSSA"	"ZOBACZ UUS"
"[english]Checkout_Review_ViewSSA"	"VIEW SSA"
"Library_ViewScreenshotsOnline"	"WYŚWIETL GALERIĘ ONLINE"
"[english]Library_ViewScreenshotsOnline"	"VIEW ONLINE GALLERY"
"Library_ScreenshotsCaption"	" - {s:caption}"
"[english]Library_ScreenshotsCaption"	" - {s:caption}"
"Library_ScreenshotUploaded"	"Wysłany"
"[english]Library_ScreenshotUploaded"	"Uploaded"
"Library_ScreenshotDeleteTitle"	"Usunąć zrzut ekranu?"
"[english]Library_ScreenshotDeleteTitle"	"Delete Screenshot?"
"Library_ScreenshotDeleteDescription"	"Na pewno chcesz usunąć ten zrzut ekranu zarówno lokalnie, jak i ze Steam Cloud (jeśli na niej jest)?"
"[english]Library_ScreenshotDeleteDescription"	"Are you sure you want to delete this screenshot both locally and from the cloud (if uploaded)?"
"Library_ScreenshotDeleteErrorTitle"	"Błąd"
"[english]Library_ScreenshotDeleteErrorTitle"	"Error"
"Library_ScreenshotDeleteErrorDescription"	"Wystąpił błąd podczas usuwania zrzutu ekranu i może on nadal znajdować się na dysku lub w chmurze."
"[english]Library_ScreenshotDeleteErrorDescription"	"There was an error deleting your screenshot, it may still be present locally or in the cloud."
"Library_ScreenshotUploadErrorTitle"	"Błąd"
"[english]Library_ScreenshotUploadErrorTitle"	"Error"
"Library_ScreenshotUploadDescription"	"Wystąpił błąd podczas wgrywania zrzutu ekranu. Usługa Steam Cloud może być teraz niedostępna."
"[english]Library_ScreenshotUploadDescription"	"There was an error uploading your screenshot.  Steam Cloud may be temporarily unavailable."
"Library_PromptScreenshotManagerTitle"	"Zarządzać zrzutami ekranu?"
"[english]Library_PromptScreenshotManagerTitle"	"Manage Screenshots?"
"Library_PromptScreenshotManagerDescription"	"Wygląda na to, że masz kilka nowych zrzutów ekranu z {s:gamename}. Czy chcesz je obejrzeć/zarządzać nimi teraz?"
"[english]Library_PromptScreenshotManagerDescription"	"It looks like you have some new screenshots from {s:gamename}, would you like to view/manage them now?"
"Library_UploadScreenshotTitle"	"Wyślij zrzut ekranu"
"[english]Library_UploadScreenshotTitle"	"Upload Screenshot"
"Library_UploadScreenshotAddComment"	"Dodaj komentarz"
"[english]Library_UploadScreenshotAddComment"	"Add Comment"
"Library_UploadScreenshotPublic"	"Publiczny"
"[english]Library_UploadScreenshotPublic"	"Public"
"Library_UploadScreenshotFriendsOnly"	"Tylko dla znajomych"
"[english]Library_UploadScreenshotFriendsOnly"	"Friends Only"
"Library_UploadScreenshotPrivate"	"Prywatny"
"[english]Library_UploadScreenshotPrivate"	"Private"
"Library_UploadScreenshotPublicAndFacebook"	"Publiczny + Facebook"
"[english]Library_UploadScreenshotPublicAndFacebook"	"Public + Facebook"
"Library_UploadScreenshotWorking"	"Praca w toku..."
"[english]Library_UploadScreenshotWorking"	"Working..."
"Library_UploadScreenshotOK"	"WYŚLIJ"
"[english]Library_UploadScreenshotOK"	"UPLOAD"
"Library_UploadScreenshotCancel"	"ANULUJ"
"[english]Library_UploadScreenshotCancel"	"CANCEL"
"TextInput_CAPS"	"WIELKIE LITERY"
"[english]TextInput_CAPS"	"CAPS"
"TextInput_LETTERS"	"LITERY"
"[english]TextInput_LETTERS"	"LETTERS"
"TextInput_NUMBERS"	"CYFRY"
"[english]TextInput_NUMBERS"	"NUMBERS"
"TextInput_SPECIAL"	"ZNAKI SPECJALNE"
"[english]TextInput_SPECIAL"	"SPECIAL"
"UI_Yes"	"TAK"
"[english]UI_Yes"	"YES"
"UI_No"	"NIE"
"[english]UI_No"	"NO"
"SettingsDisplay_RestartNow"	"Uruchomić ponownie tryb Big Picture w celu zmiany rozdzielczości?"
"[english]SettingsDisplay_RestartNow"	"Restart Big Picture now to apply your new display resolution?"
"SettingsDisplay_Intro"	"Tryb Big Picture działa w oknie bez ramki, które dopasowuje się do rozdzielczości twojego pulpitu. Rozdzielczość ustawiona przez ciebie poniżej będzie kontrolować maksymalną wewnętrzną rozdzielczość renderowania, zanim interfejs zostanie ukazany w oknie.\n\nAby zwiększyć wydajność, należy zmienić rozdzielczość docelową do 720p poniżej."
"[english]SettingsDisplay_Intro"	"Big Picture mode runs in a borderless window which matches your desktop resolution. The resolution you set below will control the maximum internal rendering resolution before the UI is presented to the window.\n\nTo improve performance, lower the target resolution to 720p below."
"SettingsDisplay_WindowSize"	"Rozmiar okna"
"[english]SettingsDisplay_WindowSize"	"Window Size"
"SettingsDisplay_SurfaceSize"	"Aktywna rozdzielczość"
"[english]SettingsDisplay_SurfaceSize"	"Active Resolution"
"SettingsDisplay_WindowSizeValue"	"{s:windowsize}"
"[english]SettingsDisplay_WindowSizeValue"	"{s:windowsize}"
"SettingsDisplay_SurfaceSizeValue"	"{s:surfacesize}"
"[english]SettingsDisplay_SurfaceSizeValue"	"{s:surfacesize}"
"Store_Available_Date"	"Dostępna dnia {s:release_date}"
"[english]Store_Available_Date"	"Available {s:release_date}"
"Checkout_Failed_InitTransaction"	"Najprawdopodobniej wystąpił błąd inicjowania lub aktualizacji transakcji. Odczekaj chwilę i spróbuj ponownie lub skontaktuj się z działem pomocy technicznej."
"[english]Checkout_Failed_InitTransaction"	"There seems to have been an error initializing or updating your transaction.  Please wait a minute and try again or contact support for assistance."
"Checkout_Failed_InitTransaction_AVS"	"Podczas weryfikacji informacji billingowych wystąpił błąd adresu. Popraw błąd lub skontaktuj się ze wsparciem technicznym."
"[english]Checkout_Failed_InitTransaction_AVS"	"Your billing information has failed address verification.  Please correct the error or contact support for assistance."
"Checkout_Failed_InitTransaction_InsufficientFunds"	"Twoje dane billingowe wskazują na brak wystarczających środków na koncie. Spróbuj je poprawić albo skontaktuj się ze wsparciem technicznym."
"[english]Checkout_Failed_InitTransaction_InsufficientFunds"	"Your billing information has reported insufficient funds are available. Please correct the error or contact support for assistance."
"Checkout_Failed_InitTransaction_Support"	"Podczas rozpoczynania transakcji wystąpił wewnętrzny błąd. Skontaktuj się ze wsparciem technicznym."
"[english]Checkout_Failed_InitTransaction_Support"	"There has been an internal error initializing your transaction.  Please contact support for assistance."
"Checkout_Failed_InitTransaction_Unavailable"	"Ta forma płatności jest obecnie niedostępna. Skontaktuj się ze wsparciem technicznym lub wybierz inny sposób płatności i spróbuj ponownie."
"[english]Checkout_Failed_InitTransaction_Unavailable"	"This payment method is currently unavailable for use.  Please contact support for assistance or select another payment method for your purchase and try again."
"Checkout_Failed_InitTransaction_ExpiredCard"	"Nie można dokonać zakupu, ponieważ wygasła ważność twojej karty kredytowej. Uaktualnij dane karty i spróbuj ponownie."
"[english]Checkout_Failed_InitTransaction_ExpiredCard"	"Your purchase could not be completed because your credit card has expired.  Please update your credit card information and try again."
"Checkout_Failed_InitTransaction_RequiredApp"	"Transakcja nie doszła do skutku, ponieważ zakupiona gra wymaga do działania innej gry, której nie posiadasz. Sprawdź wymagania produktu i spróbuj ponownie."
"[english]Checkout_Failed_InitTransaction_RequiredApp"	"Your transaction failed because you are trying to buy a game that requires ownership of another game you do not currently own.  Please correct the error and try again."
"Checkout_Failed_InitTransaction_AlreadyOwned"	"Transakcja nie została zakończona, ponieważ wygląda na to, że już posiadasz jedną z kupowanych gier. Sprawdź swoje konto i koszyk, by upewnić się, że nie chcesz kupić już posiadanego przez siebie produktu."
"[english]Checkout_Failed_InitTransaction_AlreadyOwned"	"Your purchase could not be completed because it looks like you already own one of the games you are trying to buy.  Please check your account and your cart to verify you are buying an item you do not already own."
"Checkout_Failed_InitTransaction_WalletCurrencyMismatch"	"Transakcja nie została zakończona, ponieważ środki w twoim Portfelu Steam są w innej walucie niż cena kupowanego produktu."
"[english]Checkout_Failed_InitTransaction_WalletCurrencyMismatch"	"Your purchase could not be completed because it looks like the currency of funds in your Steam Wallet does not match the currency of this purchase."
"Checkout_Failed_InitTransaction_CannotGift"	"Transakcja nie została zakończona, ponieważ w koszyku znajdują się produkty, których nie można przekazać jako prezent."
"[english]Checkout_Failed_InitTransaction_CannotGift"	"Your purchase could not be completed because your cart contains items that cannot be given as a gift."
"Checkout_Failed_InitTransaction_CannotShipInternationally"	"Transakcja nie została zakończona, ponieważ w koszyku znajdują się produkty, których nie można wysłać poza Stany Zjednoczone."
"[english]Checkout_Failed_InitTransaction_CannotShipInternationally"	"Your purchase could not be completed because your cart contains items that cannot be shipped outside the United States."
"Checkout_Failed_InitTransaction_OutOfInventory"	"Zamówienie nie może zostać zrealizowane, ponieważ jeden lub więcej produktów w twoim koszyku jest obecnie niedostępnych. Spróbuj ponownie później."
"[english]Checkout_Failed_InitTransaction_OutOfInventory"	"Your order cannot be completed because one or more items in your cart is currently out of stock.  Please try again later."
"Checkout_Failed_InitTransaction_PendingTransactions"	"Uwaga: Twoja ostatnia transakcja jest nadal w toku! Czy ostatnia płatność z usługodawcą płatności została zakończona? Nie jesteśmy jeszcze pewni i oczekujemy odpowiedzi od nich.\n\nJeżeli kontynuujesz i kupisz cokolwiek po raz drugi, ryzykujesz podwójne obciążenie rachunku."
"[english]Checkout_Failed_InitTransaction_PendingTransactions"	"Warning: Your recent transaction with us is still pending! Did you complete payment with your payment service provider? We're not sure yet, and we're waiting to receive an answer from them.\n\nIf you continue, and are purchasing any items a second time, you risk being charged twice."
"Checkout_Failed_InitTransaction_AccountLocked"	"Transakcja nie została sfinalizowana. Możliwość zakupu w sklepie Steam została zablokowana dla tego konta. Skontaktuj się z pomocą techniczną Steam."
"[english]Checkout_Failed_InitTransaction_AccountLocked"	"Your purchase was not completed. Your account is currently locked from purchasing. Please contact Steam Support for details."
"Checkout_Failed_SteamLimitExceeded"	"W celu ochrony właściciela konta ta transakcja została zablokowana. Kolejne transakcje będą tymczasowo ograniczone - skontaktuj się z pomocą techniczną Steam, by rozwiązać ten problem."
"[english]Checkout_Failed_SteamLimitExceeded"	"For the protection of the account holder, this purchase has been declined. Further purchasing will be temporarily limited - please contact Steam Support to resolve this issue."
"Checkout_Failed_OverlappingPackagesInCart"	"Transakcja nie może dojść do skutku, ponieważ kupujesz produkt już zawarty w innym zestawie w twoim koszyku. Sprawdź koszyk, aby upewnić się, że nie wybrano dwa razy tego samego produktu. Najczęstszą przyczyną tego problemu jest zakup DLC wraz z edycją kolekcjonerską obejmującą to samo DLC."
"[english]Checkout_Failed_OverlappingPackagesInCart"	"You cannot complete your transaction because you are attempting to purchase an item that is already included in another packaged item in your cart.  Please check your cart to verify that you are not are not purchasing an item multiple times.  The most common cause would be purchasing DLC along with a deluxe version of a product that already includes the same DLC."
"Checkout_Failed_GetFinalPrice_StoreCountry"	"Twój adres bilingowy nie jest zgodny z krajem, w którym obecnie przebywasz. Skontaktuj się ze wsparciem technicznym lub skorzystaj z formy płatności zgodnej z obecnym adresem."
"[english]Checkout_Failed_GetFinalPrice_StoreCountry"	"Your billing address doesn’t look like it matches up with your current country.  Please contact support for assistance or use a payment method registered to your current address."
"Checkout_Failed_Finalize_ExceedWalletMax"	"Transakcja nie została zakończona.\nIlość pieniędzy dodana do twojego portfela Steam przekroczyłaby maksymalne saldo portfela Steam."
"[english]Checkout_Failed_Finalize_ExceedWalletMax"	"Your purchase has not been completed.\nThe amount being added to your Steam Wallet would exceed the maximum allowed Steam Wallet balance."
"Checkout_Failed_Finalize_GenericError"	"Wystąpił nieprzewidziany błąd. Transakcja nie doszła do skutku. Skontaktuj się z pomocą techniczną Steam."
"[english]Checkout_Failed_Finalize_GenericError"	"An unexpected error has occurred. Your purchase has not been completed. Please contact Steam Support."
"Checkout_Failed_CCAVSError"	"Transakcja nie została zakończona. Informacje o twojej karcie kredytowej zostały odrzucone przez firmę kart kredytowych z powodu wprowadzenia błędnego adresu.\n\nNależy pamiętać, iż firma obsługująca kartę może zablokować potrzebne fundusze, ale konto nie zostanie obciążone. Po poprawieniu wszystkich błędów w poniższych danych spróbuj ponownie dokonać zakupu."
"[english]Checkout_Failed_CCAVSError"	"Your purchase has not been completed. Your credit card information has been declined by your credit card company due to an incorrect address being entered.\n\nNote that in some cases, your credit card company may put a 'hold' on funds in your account, but you will not be charged. After correcting any errors in the information displayed below, please try your purchase again."
"Checkout_Failed_TimeoutError"	"Twój komputer nie może połączyć się z serwerami Steam lub usługa może być tymczasowo niedostępna. Spróbuj ponownie później."
"[english]Checkout_Failed_TimeoutError"	"Your computer is either currently unable to reach the Steam servers, or the service may be temporarily disabled. Please try again later."
"Checkout_Failed_CC_DeclinedError"	"Transakcja nie została zakończona. Informacje o twojej karcie kredytowej zostały odrzucone przez firmę kart kredytowych.\n\nNależy pamiętać, iż firma obsługująca kartę może zablokować potrzebne fundusze, ale konto nie zostanie obciążone. Po poprawieniu wszystkich błędów w poniższych danych spróbuj ponownie dokonać zakupu."
"[english]Checkout_Failed_CC_DeclinedError"	"Your purchase has not been completed. Your credit card information has been declined by your credit card company.\n\nNote that in some cases, your credit card company may put a 'hold' on funds in your account, but you will not be charged. After correcting any errors in the information displayed below, please try your purchase again."
"Checkout_Failed_CC_InsufficientFunds"	"Transakcja nie została zakończona. Informacje o twojej karcie kredytowej zostały odrzucone przez firmę kart kredytowych z powodu braku wystarczających środków na koncie.\n\nNależy pamiętać, iż firma obsługująca kartę może zablokować potrzebne fundusze, ale konto nie zostanie obciążone."
"[english]Checkout_Failed_CC_InsufficientFunds"	"Your purchase has not been completed. Your credit card information has been declined by your credit card company due to insufficient funds in the account.\n\nNote that in some cases, your credit card company may put a 'hold' on funds in your account, but you will not be charged."
"Checkout_Failed_CC_RestrictedCountry"	"Przepraszamy, ale jeden z kupowanych produktów jest niedostępny w twoim kraju. Twoje zamówienie zostało anulowane."
"[english]Checkout_Failed_CC_RestrictedCountry"	"Sorry, but one of the items you tried to purchase is not available for purchase in this country. Your purchase has been cancelled."
"Checkout_Failed_ExceedWalletMax"	"Transakcja nie została zakończona.\nIlość pieniędzy dodana do twojego portfela Steam przekroczyłaby maksymalne saldo portfela Steam."
"[english]Checkout_Failed_ExceedWalletMax"	"Your purchase has not been completed.\nThe amount being added to your Steam Wallet would exceed the maximum allowed Steam Wallet balance."
"Checkout_Failed_AccountLocked"	"Transakcja nie została sfinalizowana. Możliwość zakupu w sklepie Steam została zablokowana dla tego konta. Skontaktuj się z pomocą techniczną Steam."
"[english]Checkout_Failed_AccountLocked"	"Your purchase was not completed. Your account is currently locked from purchasing. Please contact Steam Support for details."
"Checkout_Failed_DeclineError"	"Transakcja nie została zakończona.\nAplikacja przetwarzająca płatność zgłosiła błąd autoryzacji. Wybierz inną formę płatności."
"[english]Checkout_Failed_DeclineError"	"Your purchase has not been completed.\nThe payment processor has reported an authorization failure. Please select a different payment method."
"Checkout_Failed_UseOther"	"Transakcja nie została zakończona.\nAplikacja przetwarzająca płatność zgłosiła błąd autoryzacji. Wybierz inną formę płatności."
"[english]Checkout_Failed_UseOther"	"Your purchase has not been completed.\nThe payment processor has reported an authorization failure. Please select a different payment method."
"Checkout_Failed_UseOtherFunding"	"Transakcja nie została zakończona.\nSerwis przetwarzania płatności zgłosił błąd związany ze środkami finansowymi przypisanymi do konta. Aby naprawić ten problem, użyj serwisu przetwarzania lub wybierz inną formę płatności."
"[english]Checkout_Failed_UseOtherFunding"	"Your purchase has not been completed.\nThe payment processor has reported a problem with the funding source associated with your account. You can either correct this problem through the processor, or select a different payment method."
"Checkout_Failed_AddressError"	"Transakcja nie została zakończona.\nSerwis przetwarzania płatności zgłosił błąd związany z adresem przypisanym do konta. Aby naprawić ten problem, skontatkuj sie z serwisem przetwarzania lub wybierz inną formę płatności."
"[english]Checkout_Failed_AddressError"	"Your purchase has not been completed.\nThe payment processor has reported a problem with the address associated with your account. You can either correct this problem through the processor, or select a different payment method."
"Checkout_Failed_RegionError"	"Transakcja nie została zakończona.\nWybrana forma płatności jest obecnie niedostępna w twoim kraju. Wybierz inną formę płatności."
"[english]Checkout_Failed_RegionError"	"Your purchase has not been completed.\nYour chosen payment method is currently unavailable in your country. Please choose a different payment method."
"Checkout_Failed_BlockedAccountError"	"Transakcja nie została zakończona.\nSerwis przetwarzania płatności zgłosił błąd związany z kontem. Skontaktuj się z serwisem przetwarzania lub wybierz inną metodę płatności."
"[english]Checkout_Failed_BlockedAccountError"	"Your purchase has not been completed.\nThe payment processor has reported a problem with your account. Please contact the processor or choose an alternate payment method."
"Checkout_Failed_NotVerified"	"Transakcja nie została zakończona.\nAplikacja przetwarzająca płatność zgłosiła konieczność zweryfikowania lub zasilenia twojego konta, aby zakup mógł zostać sfinalizowany. Skontaktuj się z serwisem przetwarzania lub wybierz inną metodę płatności."
"[english]Checkout_Failed_NotVerified"	"Your purchase has not been completed.\nThe payment processor has reported that your account needs to be verified or funded to complete the purchase. Please contact the processor or choose an alternate payment method."
"Checkout_Failed_Finalize_AccountLocked"	"Transakcja nie została sfinalizowana. Możliwość zakupu w sklepie Steam została zablokowana dla tego konta. Skontaktuj się z pomocą techniczną Steam."
"[english]Checkout_Failed_Finalize_AccountLocked"	"Your purchase was not completed. Your account is currently locked from purchasing. Please contact Steam Support for details."
"UI_Next"	"DALEJ"
"[english]UI_Next"	"NEXT"
"SettingsDisplay_DisplayDevice"	"Urządzenie graficzne"
"[english]SettingsDisplay_DisplayDevice"	"Display Device"
"SettingsDisplay_DisplayDeviceValue"	"{s:gpuinfostring}"
"[english]SettingsDisplay_DisplayDeviceValue"	"{s:gpuinfostring}"
"SettingsDisplay_RestartNowMonitor"	"Zrestartować tryb Big Picture teraz, aby zastosować twój wybór monitora?"
"[english]SettingsDisplay_RestartNowMonitor"	"Restart Big Picture now to apply your monitor selection?"
"SettingsDisplay_Warning"	"Ostrzeżenie"
"[english]SettingsDisplay_Warning"	"Warning"
"SettingsDisplay_StrongWarningVideoMemory"	"Twoje urządzenie graficzne posiada tylko {s:dedicatedgpumem} dedykowanej pamięci GPU. Na rozdzielczości {s:selectedres} twoja wydajność najprawdopodobniej spadnie.\n\nCzy na pewno chcesz taką ustawić?"
"[english]SettingsDisplay_StrongWarningVideoMemory"	"Your display device has only {s:dedicatedgpumem} of dedicated GPU memory.  You are likely to have poor performance at {s:selectedres}.\n\nAre you sure you want to set it anyway?"
"SettingsDisplay_WarningVideoMemory"	"Twoje urządzenie graficzne posiada {s:dedicatedgpumem} dedykowanej pamięci GPU. Możliwe, że na rozdzielczości {s:selectedres} twoja wydajność spadnie.\n\nCzy na pewno chcesz taką ustawić?"
"[english]SettingsDisplay_WarningVideoMemory"	"Your display device has {s:dedicatedgpumem} of dedicated GPU memory. You might experience decreased performance at {s:selectedres}.\n\nAre you sure you want to set it anyway?"
"SettingsDisplay_Monitor"	"Monitor docelowy"
"[english]SettingsDisplay_Monitor"	"Target Monitor"
"SettingsAudio_MuteAll"	"Wycisz wszystko"
"[english]SettingsAudio_MuteAll"	"Mute All"
"SettingsAudio_Ambient"	"Dźwięki tła"
"[english]SettingsAudio_Ambient"	"Ambient Sounds"
"SettingsAudio_Movies"	"Filmy"
"[english]SettingsAudio_Movies"	"Movies"
"SettingsAudio_Navigation"	"Odgłosy nawigacji"
"[english]SettingsAudio_Navigation"	"Navigation sounds"
"Search_NoResultsFound"	"Nic nie znaleziono"
"[english]Search_NoResultsFound"	"No results found"
"Search_NoInputEntered"	"Wpisz szukany tekst"
"[english]Search_NoInputEntered"	"Enter search text"
"Search_SearchError"	"Podczas wyszukiwania wystąpił błąd"
"[english]Search_SearchError"	"An error occurred while search"
"Library_ScreenshotsSlideshowSubTitle"	"Zrzut ekranu {d:curss} z {d:totalss}"
"[english]Library_ScreenshotsSlideshowSubTitle"	"Screenshot {d:curss} of {d:totalss}"
"Web_NextTab"	"NASTĘPNA KARTA"
"[english]Web_NextTab"	"NEXT TAB"
"Web_Previous"	"POPRZEDNIA KARTA"
"[english]Web_Previous"	"PREV TAB"
"Month_January"	"Styczeń"
"[english]Month_January"	"January"
"Month_February"	"Luty"
"[english]Month_February"	"February"
"Month_March"	"Marzec"
"[english]Month_March"	"March"
"Month_April"	"Kwiecień"
"[english]Month_April"	"April"
"Month_May"	"Maj"
"[english]Month_May"	"May"
"Month_June"	"Czerwiec"
"[english]Month_June"	"June"
"Month_July"	"Lipiec"
"[english]Month_July"	"July"
"Month_August"	"Sierpień"
"[english]Month_August"	"August"
"Month_September"	"Wrzesień"
"[english]Month_September"	"September"
"Month_October"	"Październik"
"[english]Month_October"	"October"
"Month_November"	"Listopad"
"[english]Month_November"	"November"
"Month_December"	"Grudzień"
"[english]Month_December"	"December"
"UI_Continue"	"Kontynuuj"
"[english]UI_Continue"	"Continue"
"SettingsDisplay_NonPrimaryMonitor"	"Ostrzeżenie"
"[english]SettingsDisplay_NonPrimaryMonitor"	"Warning"
"SettingsDisplay_NonPrimaryMonitorWarning"	"{s:selectedmonitor} nie jest twoim głównym monitorem. Ponieważ gry można uruchomić tylko na monitorze głównym, Steam będzie go automatycznie dostosowywał podczas uruchamiania i wyłączania trybu Big Picture.\n\nCzy na pewno chcesz kontynuować?"
"[english]SettingsDisplay_NonPrimaryMonitorWarning"	"{s:selectedmonitor} is not your primary monitor.  Since games can only run on your primary monitor Steam will adjust it automatically when entering and exiting Big Picture.\n\nAre you sure you want to proceed?"
"Store_EnterBirthday"	"Podaj swoją datę urodzenia:"
"[english]Store_EnterBirthday"	"Please enter your birth date to continue:"
"Store_AgeRestricted"	"Przepraszamy, nie możesz teraz przeglądać tych materiałów."
"[english]Store_AgeRestricted"	"Sorry, but you're not permitted to view these materials at this time."
"Store_AppPurchaseSection_AddingToWishlist"	"Dodawanie do listy życzeń..."
"[english]Store_AppPurchaseSection_AddingToWishlist"	"Adding to wishlist..."
"Store_AppPurchaseSection_ViewWishlist"	"Zobacz na liście życzeń"
"[english]Store_AppPurchaseSection_ViewWishlist"	"View in wishlist"
"Library_Details_ControllerSupport"	"KONTROLER"
"[english]Library_Details_ControllerSupport"	"CONTROLLER"
"Library_Details_FullController"	"Pełne wsparcie!"
"[english]Library_Details_FullController"	"Full support!"
"Library_Details_PartialController"	"Częściowe wsparcie"
"[english]Library_Details_PartialController"	"Partial support"
"Library_ControllerSupport"	"Wsparcie dla kontrolera ({d:controller})"
"[english]Library_ControllerSupport"	"Controller Supported ({d:controller})"
"Library_Details_RemoveFromFavorites"	"Usuń z ulubionych"
"[english]Library_Details_RemoveFromFavorites"	"Remove from Favorites"
"Library_Details_AddToFavorites"	"Dodaj do ulubionych"
"[english]Library_Details_AddToFavorites"	"Add to Favorites"
"10ft_Friends_Chat_FriendStateChanged"	"jest teraz {s:friend_status_change}."
"[english]10ft_Friends_Chat_FriendStateChanged"	"is now {s:friend_status_change}."
"Library_Details_LegacyCDKey"	"Wyświetl nr seryjny"
"[english]Library_Details_LegacyCDKey"	"View CD Key"
"Library_UploadScreenshotSpoilerTag"	"Oznacz jako potencjalny spoiler"
"[english]Library_UploadScreenshotSpoilerTag"	"Tag as potential spoiler"
"Library_CDKeyTitle"	"Numer seryjny"
"[english]Library_CDKeyTitle"	"CD Key"
"Library_CDKey_Description"	"To jest twój numer seryjny do {s:gamename}. Po uruchomieniu aplikacji należy wprowadzić ten numer. Zapisz teraz numer seryjny lub naciśnij przycisk „Skopiuj do schowka”."
"[english]Library_CDKey_Description"	"This is your activation key for {s:gamename}.  You will need to enter this key after the game has launched.  Write the key down or copy to clipboard now."
"Library_CDKey_DontShowAgain"	"Nie pokazuj mi tego więcej"
"[english]Library_CDKey_DontShowAgain"	"Don't show me this again"
"Library_CopyToClipboardButton"	"SKOPIUJ DO SCHOWKA"
"[english]Library_CopyToClipboardButton"	"COPY TO CLIPBOARD"
"Library_CloseButton"	"ZAMKNIJ"
"[english]Library_CloseButton"	"CLOSE"
"Library_CopyToClipboardAndLaunchButton"	"SKOPIUJ DO SCHOWKA I URUCHOM"
"[english]Library_CopyToClipboardAndLaunchButton"	"COPY TO CLIPBOARD AND LAUNCH"
"Library_LaunchButton"	"URUCHOM"
"[english]Library_LaunchButton"	"LAUNCH"
"Library_CDKeyFetchErrorTitle"	"Błąd"
"[english]Library_CDKeyFetchErrorTitle"	"Error"
"Library_CDKeyFetchError"	"Steam nie mógł w tym momencie uzyskać danych o twoich numerach seryjnych, spróbuj ponownie później."
"[english]Library_CDKeyFetchError"	"Steam couldn't get data on your CD Key's at this time, please try again later."
"Library_CDKeyFetchWorking"	"Praca w toku..."
"[english]Library_CDKeyFetchWorking"	"Working..."
"Library_CloudConflictTitle"	"Problem z synchronizacją ze Steam Cloud"
"[english]Library_CloudConflictTitle"	"Cloud Sync Conflict"
"Library_CloudConflict_Description"	"Twoje lokalne pliki gry {s:gamename} są niezgodne z plikami umieszczonymi w Steam Cloud."
"[english]Library_CloudConflict_Description"	"Your local {s:gamename} files conflict with the ones stored in the Steam Cloud."
"Library_CloudConflict_Upload"	"Wyślij moje pliki lokalne do Steam Cloud"
"[english]Library_CloudConflict_Upload"	"Upload my local files to the Steam Cloud"
"Library_CloudConflict_LocalFilesModified"	"Pliki lokalne były ostatnio modyfikowane {t:s:localmodified} o {t:T:localmodified}"
"[english]Library_CloudConflict_LocalFilesModified"	"Local files last modified {t:s:localmodified} at {t:T:localmodified}"
"Library_CloudConflict_Download"	"Pobierz moje pliki ze Steam Cloud na ten komputer"
"[english]Library_CloudConflict_Download"	"Download my cloud files to this computer"
"Library_CloudConflict_CloudFilesModified"	"Pliki Steam Cloud były ostatnio modyfikowane {t:s:remotemodified} o {t:T:remotemodified}"
"[english]Library_CloudConflict_CloudFilesModified"	"Cloud files last modified {t:s:remotemodified} at {t:T:remotemodified}"
"Library_CloudConflict_Cancel"	"Niczego teraz nie rób"
"[english]Library_CloudConflict_Cancel"	"Don't do anything now"
"Library_CloudConflict_CancelDetails"	"Musisz wybrać wysłanie lub pobranie plików, aby uruchomić grę"
"[english]Library_CloudConflict_CancelDetails"	"You must choose upload or download to launch the game"
"Library_CloudSyncFailed_Title"	"Błąd Steam Cloud"
"[english]Library_CloudSyncFailed_Title"	"Steam Cloud Error"
"Library_CloudSyncFailed_Detail"	"Synchronizacja plików gry {s:gamename} z usługą Steam Cloud nie powiodła się\n\nJeśli aplikacja ta została przez ciebie uruchomiona z innego komputera, twoje ustawienia w niej i/lub wszelkie postępy mogą nie być zsynchronizowane z danymi przechowanymi w Steam Cloud. Jeśli uruchomisz teraz tę aplikację, możesz utracić te zmiany lub postępy."
"[english]Library_CloudSyncFailed_Detail"	"Steam was unable to sync your files for {s:gamename} with the Steam Cloud.\n\nIf you have launched this application from another computer, your application settings and/or progress may not be in sync with what is stored in the Cloud. If you launch the application now, you may lose those changes or progress."
"Library_CloudSyncFailed_LaunchAnyway"	"MIMO TO URUCHOM"
"[english]Library_CloudSyncFailed_LaunchAnyway"	"LAUNCH ANYWAY"
"Login_AccountName"	"NAZWA KONTA"
"[english]Login_AccountName"	"ACCOUNT NAME"
"Login_Password"	"HASŁO"
"[english]Login_Password"	"PASSWORD"
"Login_Login"	"LOGIN"
"[english]Login_Login"	"LOGIN"
"Login_RememberPassword"	"Zapamiętaj moje hasło"
"[english]Login_RememberPassword"	"Remember My Password"
"Login_LoggedInElsewhere"	"To konto jest aktualnie używane w innym miejscu. Wprowadź ponownie hasło, aby się zalogować."
"[english]Login_LoggedInElsewhere"	"This account is currently logged in elsewhere. Please re-enter your password to login."
"Login_SteamGuardCode"	"KOD DOSTĘPU"
"[english]Login_SteamGuardCode"	"ACCESS CODE"
"Login_SteamGuardPrompt"	"Steam Guard wymaga wprowadzenia specjalnego kodu dostępu, który wysłaliśmy do ciebie na {s:domain}"
"[english]Login_SteamGuardPrompt"	"Steam Guard requires you to enter the special access code we've just emailed to you at {s:domain}"
"Login_SteamGuardExpired"	"Ten kod jest zbyt stary i utracił ważność."
"[english]Login_SteamGuardExpired"	"That code is too old and has expired."
"Login_SteamGuardWrongCode"	"Przepraszamy, ten kod nie jest poprawny."
"[english]Login_SteamGuardWrongCode"	"Sorry, that code isn't quite right."
"Login_WrongPassword"	"Sprawdź nazwę swojego konta oraz hasło, po czym spróbuj ponownie."
"[english]Login_WrongPassword"	"Please check your account name and password and try again."
"Login_IPRestriction"	"Nie można uzyskać dostępu do konta z tego miejsca."
"[english]Login_IPRestriction"	"This account can't be accessed from this location."
"Login_Connecting"	"Łączenie z kontem Steam {s:AccountName}..."
"[english]Login_Connecting"	"Connecting to Steam account {s:AccountName}..."
"Login_AccountSuspended"	"To konto zostało zawieszone.\n\nTypowe powody zawieszenia to uzyskanie dostępu do konta przez inną osobę oraz problem z płatnością.\n\nSkontaktuj się z pomocą techniczną Steam, aby rozwiązać ten problem."
"[english]Login_AccountSuspended"	"Steam Support has suspended this account.\n\nAccounts typically become suspended when accessed by someone else, or a payment dispute is in progress.\n\nPlease contact Steam Support to resolve this issue."
"Login_ContactSupport"	"Skontaktuj się z pomocą techniczną"
"[english]Login_ContactSupport"	"Contact Support"
"Login_UpdatingPlatform"	"Aktualizacja Steam..."
"[english]Login_UpdatingPlatform"	"Updating Steam..."
"Login_Offline"	"Aktualnie Steam działa w trybie offline.\n\nW tym trybie niedostępnych jest wiele funkcji, np. sklep i Społeczność Steam."
"[english]Login_Offline"	"Steam is currently set to Offline Mode.\n\nMany features, such as the Steam Store and Community, will not be available while offline."
"Login_GoOnline"	"Przejdź w tryb online"
"[english]Login_GoOnline"	"Go Online"
"Login_StayOffline"	"Pozostań Offline"
"[english]Login_StayOffline"	"Stay Offline"
"Login_ConnectionIssues"	"Nie można połączyć się z siecią Steam. Sprawdź swoje połączenie internetowe i spróbuj ponownie."
"[english]Login_ConnectionIssues"	"Can't connect to the Steam service. Check your network connection or try again later."
"Login_NextField"	"DALEJ"
"[english]Login_NextField"	"NEXT"
"Login_LoginRetry"	"Spróbuj ponownie"
"[english]Login_LoginRetry"	"Retry Connection"
"SettingsAccount_StartBPM"	"Uruchom Steam w trybie Big Picture"
"[english]SettingsAccount_StartBPM"	"Start Steam in Big Picture Mode"
"Store_AppPurchaseOptions_AppDetails"	"Wyświetl szczegóły gry"
"[english]Store_AppPurchaseOptions_AppDetails"	"View Game Details"
"Library_Details_Press"	"NACIŚNIJ"
"[english]Library_Details_Press"	"PRESS"
"Library_Details_ToTakeScreenshot"	"ABY WYKONAĆ ZRZUT EKRANU"
"[english]Library_Details_ToTakeScreenshot"	"TO TAKE A SCREENSHOT"
"Steam_ErrorCantStartGameDetailed"	"Nie udało się uruchomić gry ({s:error})."
"[english]Steam_ErrorCantStartGameDetailed"	"Failed to start game ({s:error})."
"Steam_ErrorCantStartGameDependency"	"Nie udało się uruchomić gry ze współdzieloną zawartością. Uaktualnij następujące gry:\n\n {s:dependencies}"
"[english]Steam_ErrorCantStartGameDependency"	"Failed to start game with shared content. Please update these games first:\n\n  {s:dependencies}"
"Steam_ErrorCantStartGameLink"	"Pomoc"
"[english]Steam_ErrorCantStartGameLink"	"Help"
"Steam_AppUpdateError_0"	"brak błędów"
"[english]Steam_AppUpdateError_0"	"no error"
"Steam_AppUpdateError_1"	"nieznany błąd"
"[english]Steam_AppUpdateError_1"	"unknown error"
"Steam_AppUpdateError_2"	"aktualizacja przerwana"
"[english]Steam_AppUpdateError_2"	"update paused"
"Steam_AppUpdateError_3"	"aktualizacja anulowana"
"[english]Steam_AppUpdateError_3"	"update canceled"
"Steam_AppUpdateError_4"	"aktualizacja zatrzymana"
"[english]Steam_AppUpdateError_4"	"update suspended"
"Steam_AppUpdateError_5"	"brak licencji"
"[english]Steam_AppUpdateError_5"	"no licenses"
"Steam_AppUpdateError_6"	"brak połączenia z internetem"
"[english]Steam_AppUpdateError_6"	"no internet connection"
"Steam_AppUpdateError_7"	"przekroczenie limitu czasu połączenia"
"[english]Steam_AppUpdateError_7"	"connection time out"
"Steam_AppUpdateError_8"	"zawartość jest wciąż zaszyfrowana"
"[english]Steam_AppUpdateError_8"	"content still encrypted"
"Steam_AppUpdateError_9"	"brakująca konfiguracja aplikacji"
"[english]Steam_AppUpdateError_9"	"missing app configuration"
"Steam_AppUpdateError_10"	"błąd odczytu dysku"
"[english]Steam_AppUpdateError_10"	"disk read error"
"Steam_AppUpdateError_11"	"błąd zapisu na dysku"
"[english]Steam_AppUpdateError_11"	"disk write error"
"Steam_AppUpdateError_12"	"za mało miejsca na dysku"
"[english]Steam_AppUpdateError_12"	"not enough disk space"
"Steam_AppUpdateError_13"	"uszkodzone pliki zawartości"
"[english]Steam_AppUpdateError_13"	"corrupt content files"
"Steam_AppUpdateError_14"	"oczekiwanie na płytę instalacyjną"
"[english]Steam_AppUpdateError_14"	"waiting for install disc"
"Steam_AppUpdateError_15"	"nieprawidłowa ścieżka instalacyjna"
"[english]Steam_AppUpdateError_15"	"invalid install path"
"Steam_AppUpdateError_16"	"aplikacja jest już uruchomiona"
"[english]Steam_AppUpdateError_16"	"app already running"
"Steam_AppUpdateError_17"	"brakująca współdzielona zawartość"
"[english]Steam_AppUpdateError_17"	"missing shared content"
"Steam_AppUpdateError_18"	"nie zainstalowano"
"[english]Steam_AppUpdateError_18"	"not installed"
"Steam_AppUpdateError_19"	"wymagana aktualizacja"
"[english]Steam_AppUpdateError_19"	"update required"
"Steam_AppUpdateError_20"	"zajęty"
"[english]Steam_AppUpdateError_20"	"busy"
"Steam_AppUpdateError_21"	"serwery zawartości nieosiągalne"
"[english]Steam_AppUpdateError_21"	"content servers unreachable"
"Steam_AppUpdateError_22"	"nieprawidłowa konfiguracja aplikacji"
"[english]Steam_AppUpdateError_22"	"invalid app config"
"Steam_AppUpdateError_23"	"nieprawidłowa konfiguracja zawartości"
"[english]Steam_AppUpdateError_23"	"invalid depot config"
"Steam_AppUpdateError_24"	"brak listy zawartości"
"[english]Steam_AppUpdateError_24"	"missing content manifest"
"Steam_AppUpdateError_25"	"aplikacja nie została jeszcze wydana"
"[english]Steam_AppUpdateError_25"	"app not released"
"Steam_AppUpdateError_26"	"blokada regionalna"
"[english]Steam_AppUpdateError_26"	"region restricted"
"Steam_AppUpdateError_27"	"uszkodzone cache zawartości"
"[english]Steam_AppUpdateError_27"	"corrupt content cache"
"Steam_AppUpdateError_28"	"brakujący plik wykonywalny"
"[english]Steam_AppUpdateError_28"	"missing executable"
"Friends_FriendsActions"	"Znajomi"
"[english]Friends_FriendsActions"	"Friends"
"Friends_SetPersonaStatus"	"Ustaw status"
"[english]Friends_SetPersonaStatus"	"Set Status"
"Friends_PersonaOffline"	"Offline"
"[english]Friends_PersonaOffline"	"Offline"
"Friends_PersonaOnline"	"Online"
"[english]Friends_PersonaOnline"	"Online"
"Friends_PersonaAway"	"Zaraz wracam"
"[english]Friends_PersonaAway"	"Away"
"Friends_PersonaBusy"	"Zajęty"
"[english]Friends_PersonaBusy"	"Busy"
"Friends_PersonaLookingToPlay"	"Chcę pograć"
"[english]Friends_PersonaLookingToPlay"	"Looking to Play"
"Friends_PersonaLookingToTrade"	"Chcę się wymienić"
"[english]Friends_PersonaLookingToTrade"	"Looking to Trade"
"Friends_View"	"Widok"
"[english]Friends_View"	"View"
"Friends_FriendsOnly"	"Tylko znajomi"
"[english]Friends_FriendsOnly"	"Friends Only"
"Friends_AllFriendsAndRequests"	"Znajomi i zaproszenia"
"[english]Friends_AllFriendsAndRequests"	"Friends and Requests"
"Friends_OnlineFriendsOnly"	"Tylko znajomi online"
"[english]Friends_OnlineFriendsOnly"	"Online Friends Only"
"Friends_ChangeProfileName"	"Zmień nazwę profilu"
"[english]Friends_ChangeProfileName"	"Change Profile Name"
"Friends_EditProfile"	"Edytuj profil"
"[english]Friends_EditProfile"	"Edit Profile"
"Friends_AddFriendAction"	"Dodaj znajomego"
"[english]Friends_AddFriendAction"	"Add a Friend"
"Friends_FriendsActionsFooter"	"AKCJE"
"[english]Friends_FriendsActionsFooter"	"ACTIONS"
"TextInput_EnteredText"	"Wprowadzony tekst:"
"[english]TextInput_EnteredText"	"Entered text:"
"Panorama_MoviePlaybackError"	"Wystąpił błąd podczas odtwarzania"
"[english]Panorama_MoviePlaybackError"	"An error ocurred during playback"
"Trailer_Slideshow_Error"	"Chwilowo nie można załadować zwiastunów"
"[english]Trailer_Slideshow_Error"	"Unable to load trailers at this time"
"Downloads_ItemDownloading"	"POBIERANYCH ELEMENTÓW: 1"
"[english]Downloads_ItemDownloading"	"1 ITEM DOWNLOADING"
"Downloads_ItemPaused"	"WSTRZYMANYCH ELEMENTÓW: 1"
"[english]Downloads_ItemPaused"	"1 ITEM PAUSED"
"MainMenu_NewComments"	"Nowe komentarze: {d:commentcount}"
"[english]MainMenu_NewComments"	"{d:commentcount} new comments"
"MainMenu_NewItems"	"Nowe przedmioty w ekwipunku: {d:itemcount}"
"[english]MainMenu_NewItems"	"{d:itemcount} new inventory items"
"MainMenu_NewInvites"	"Nowe zaproszenia: {d:friendinvitecount}"
"[english]MainMenu_NewInvites"	"{d:friendinvitecount} new invites"
"MainMenu_NewGifts"	"Nowe prezenty: {d:giftcount}"
"[english]MainMenu_NewGifts"	"{d:giftcount} new gifts"
"Library_Platform"	"Gry {s:platformname} ({d:platform})"
"[english]Library_Platform"	"{s:platformname} games ({d:platform})"
"Friends_ProfileDetails_Action_InviteToGame"	"Zaproś do gry"
"[english]Friends_ProfileDetails_Action_InviteToGame"	"Invite to Game"
"UI_Label_CopySelected"	"Skopiuj zaznaczony tekst"
"[english]UI_Label_CopySelected"	"Copy selected text"
"UI_Label_OpenLinkInBrowser"	"Otwórz adres URL w przeglądarce"
"[english]UI_Label_OpenLinkInBrowser"	"Open URL in browser"
"UI_Label_CopyURLToClipboard"	"Skopiuj adres URL do schowka"
"[english]UI_Label_CopyURLToClipboard"	"Copy URL to clipboard"
"UI_TextEntry_CutToClipboard"	"Wytnij"
"[english]UI_TextEntry_CutToClipboard"	"Cut"
"UI_TextEntry_CopyToClipboard"	"Skopiuj"
"[english]UI_TextEntry_CopyToClipboard"	"Copy"
"UI_TextEntry_PasteClipboard"	"Wklej"
"[english]UI_TextEntry_PasteClipboard"	"Paste"
"MainMenu_NewCommentsSingular"	"{d:commentcount} nowy komentarz"
"[english]MainMenu_NewCommentsSingular"	"{d:commentcount} new comment"
"MainMenu_NewItemsSingular"	"{d:itemcount} nowy przedmiot w ekwipunku"
"[english]MainMenu_NewItemsSingular"	"{d:itemcount} new inventory item"
"MainMenu_NewInvitesSingular"	"{d:friendinvitecount} nowe zaproszenie"
"[english]MainMenu_NewInvitesSingular"	"{d:friendinvitecount} new invite"
"MainMenu_NewGiftsSingular"	"{d:giftcount} nowy prezent"
"[english]MainMenu_NewGiftsSingular"	"{d:giftcount} new gift"
"Store_AppPurchaseSection_ViewInLibrary"	"Zobacz w bibliotece"
"[english]Store_AppPurchaseSection_ViewInLibrary"	"View in library"
"Library_Details_GameHubPage"	"Strona centrum gry"
"[english]Library_Details_GameHubPage"	"Game Hub Page"
"Friends_ChooseURL"	"Otwórz adres URL w przeglądarce"
"[english]Friends_ChooseURL"	"Open URL in browser"
"Friends_ChooseURL_Cancel"	"ANULUJ"
"[english]Friends_ChooseURL_Cancel"	"CANCEL"
"Friends_PressRightStickForURLs"	"Aby poruszać się po linkach, naciśnij prawy drążek"
"[english]Friends_PressRightStickForURLs"	"To navigate links, press RS"
"10ft_chat_entered"	"{s:participant} dołącza do czatu."
"[english]10ft_chat_entered"	"{s:participant} entered chat."
"10ft_chat_left"	"{s:participant} opuszcza czat."
"[english]10ft_chat_left"	"{s:participant} left chat."
"10ft_chat_disconnected"	"{s:participant} rozłącza się."
"[english]10ft_chat_disconnected"	"{s:participant} disconnected."
"10ft_chat_kicked"	"{s:actor} wyrzuca {s:participant}."
"[english]10ft_chat_kicked"	"{s:participant} was kicked by {s:actor}."
"10ft_chat_banned"	"{s:actor} blokuje {s:participant}."
"[english]10ft_chat_banned"	"{s:participant} was banned by {s:actor}."
"SettingsController_ControllerName"	"Wykryte kontrolery: {s:controllername}"
"[english]SettingsController_ControllerName"	"Controller Detected: {s:controllername}"
"SettingsController_ControllerAction"	"{s:controlleraction}"
"[english]SettingsController_ControllerAction"	"{s:controlleraction}"
"SettingsController_Detected"	" "
"[english]SettingsController_Detected"	""
"SettingsController_ConfigureController"	"Edytuj układ kontrolera"
"[english]SettingsController_ConfigureController"	"Edit controls"
"SettingsController_DifferentLook"	"Uwaga: twój kontroler może wyglądać inaczej niż ten."
"[english]SettingsController_DifferentLook"	"Note: your gamepad may look different from this one."
"SettingsController_PressButton"	"Jeżeli twój kontroler posiada przycisk zlokalizowany w podobnym miejscu do tego pokazanego tutaj, zalecamy używać go do wybranych działań."
"[english]SettingsController_PressButton"	"If your gamepad has a button in a location similar to the one shown here, we recommend it for the selected action."
"SettingsController_ButtonNone"	"---"
"[english]SettingsController_ButtonNone"	"---"
"SettingsController_ButtonA"	"A"
"[english]SettingsController_ButtonA"	"A"
"SettingsController_PrimaryAction"	"Działanie główne"
"[english]SettingsController_PrimaryAction"	"Primary Action"
"SettingsController_Icon"	"Ikona"
"[english]SettingsController_Icon"	"Icon"
"SettingsController_Command"	"Komenda"
"[english]SettingsController_Command"	"Command"
"SettingsController_Button"	"Przycisk"
"[english]SettingsController_Button"	"Button"
"SettingsController_Save"	"ZAPISZ"
"[english]SettingsController_Save"	"SAVE"
"SettingsController_ButtonBind"	"Przycisk {i:button}"
"[english]SettingsController_ButtonBind"	"Button {i:button}"
"SettingsController_AxisBind"	"Oś {i:axis}"
"[english]SettingsController_AxisBind"	"Axis {i:axis}"
"SettingsController_HatBind"	"Kapturek {i:hat}.{i:mask}"
"[english]SettingsController_HatBind"	"Hat {i:hat}.{i:mask}"
"SettingsController_NeedMoreBinds"	"Musisz przypisać następujące przyciski: {s:missingbuttons}"
"[english]SettingsController_NeedMoreBinds"	"You need to bind the following buttons: {s:missingbuttons}"
"SettingsController_SaveBeforeExit"	"Wyjść bez zapisywania zmian?"
"[english]SettingsController_SaveBeforeExit"	"Exit without saving changes?"
"SettingsController_LeftStickX"	"Oś X lewego drążka"
"[english]SettingsController_LeftStickX"	"Left Stick X"
"SettingsController_LeftStickY"	"Oś Y lewego drążka"
"[english]SettingsController_LeftStickY"	"Left Stick Y"
"SettingsController_RightStickX"	"Oś X prawego drążka"
"[english]SettingsController_RightStickX"	"Right Stick X"
"SettingsController_RightStickY"	"Oś Y prawego drążka"
"[english]SettingsController_RightStickY"	"Right Stick Y"
"SettingsController_TriggerLeft"	"Lewy trigger"
"[english]SettingsController_TriggerLeft"	"Left Trigger"
"SettingsController_TriggerRight"	"Prawy trigger"
"[english]SettingsController_TriggerRight"	"Right Trigger"
"SettingsController_A"	"Działanie główne"
"[english]SettingsController_A"	"Primary Action"
"SettingsController_B"	"Wróć"
"[english]SettingsController_B"	"Go back"
"SettingsController_X"	"Działanie drugorzędne"
"[english]SettingsController_X"	"Secondary Action"
"SettingsController_Y"	"Działanie trzeciorzędne"
"[english]SettingsController_Y"	"Tertiary Action"
"SettingsController_Start"	"Start"
"[english]SettingsController_Start"	"Start"
"SettingsController_Back"	"Back"
"[english]SettingsController_Back"	"Back"
"SettingsController_Guide"	"Guide"
"[english]SettingsController_Guide"	"Guide"
"SettingsController_LeftStick"	"Naciśnięcie lewego drążka"
"[english]SettingsController_LeftStick"	"Left Stick click"
"SettingsController_RightStick"	"Naciśnięcie prawego drążka"
"[english]SettingsController_RightStick"	"Right Stick click"
"SettingsController_LeftShoulder"	"Lewy przycisk przedni"
"[english]SettingsController_LeftShoulder"	"Left Shoulder"
"SettingsController_RightShoulder"	"Prawy przycisk przedni"
"[english]SettingsController_RightShoulder"	"Right Shoulder"
"SettingsController_Up"	"Górny przycisk krzyżaka"
"[english]SettingsController_Up"	"DPAD Up"
"SettingsController_Down"	"Dolny przycisk krzyżaka"
"[english]SettingsController_Down"	"DPAD Down"
"SettingsController_Left"	"Lewy przycisk krzyżaka"
"[english]SettingsController_Left"	"DPAD Left"
"SettingsController_Right"	"Prawy przycisk krzyżaka"
"[english]SettingsController_Right"	"DPAD Right"
"SettingsController_ShareTitle"	"Czy chcesz się podzielić ustawieniami dla tego kontrolera?"
"[english]SettingsController_ShareTitle"	"Share this controller definition?"
"SettingsController_Share"	"Pomóż innym użytkownikom poprzez nazwanie tego kontrolera:"
"[english]SettingsController_Share"	"Please help support this controller for other users by giving it a name:"
"SettingsController_ShareExample"	"Na przykład „Logitech A710”"
"[english]SettingsController_ShareExample"	"For example, \"Logitech A710\""
"SettingsController_CommitUpload"	"Tak. Wyślij!"
"[english]SettingsController_CommitUpload"	"Yes. Upload!"
"SettingsController_CommitCancel"	"Nie, dziękuję."
"[english]SettingsController_CommitCancel"	"No thanks."
"SettingsController_NoneDetected"	"Nie wykryto kontrolera."
"[english]SettingsController_NoneDetected"	"No controller detected."
"SettingsController_XInputController"	"Kontroler kompatybilny z XInput"
"[english]SettingsController_XInputController"	"XInput compatible controller"
"Store_Unavailable"	"Sklep Steam jest obecnie niedostępny. Spróbuj ponownie później."
"[english]Store_Unavailable"	"The Steam store is currently unavailable. Please try again later."
"Store_AppPurchaseOptions_LoadingError"	"Wystąpił błąd podczas ładowania opcji zakupu. Spróbuj ponownie."
"[english]Store_AppPurchaseOptions_LoadingError"	"An error occurred while loading the purchase options. Please try again."
"Store_BrowseByCategory_LoadingError"	"Steam nie mógł załadować wymaganych danych sklepu. Spróbuj ponownie."
"[english]Store_BrowseByCategory_LoadingError"	"Steam was unable to load the requested store data. Please try again."
"MainMenu_NewSupportMessages"	"1 wiadomość od pomocy tech. Steam"
"[english]MainMenu_NewSupportMessages"	"1 message from Steam Support"
"SupportMessages_Title"	"Wiadomość od pomocy technicznej Steam"
"[english]SupportMessages_Title"	"Support Message"
"SupportMessages_Text"	"Masz wiadomość od pomocy technicznej Steam."
"[english]SupportMessages_Text"	"You have a message from Steam Support."
"SupportMessages_View"	"Zobacz wiadomość"
"[english]SupportMessages_View"	"View Message"
"Steam_RefreshLogin_InfoTicketExpired"	"Twoje dane logowania straciły ważność.\nPodaj hasło, aby kontynuować."
"[english]Steam_RefreshLogin_InfoTicketExpired"	"Your Steam ticket has expired.\nPlease re-enter your password to continue."
"Steam_RefreshLogin_InvalidPassword"	"Twoje dane uwierzytelniające straciły ważność.\nPonownie wpisz hasło, aby kontynuować."
"[english]Steam_RefreshLogin_InvalidPassword"	"Your account credentials have expired.\nPlease re-enter your password to continue."
"Steam_RefreshLogin_PurchaseSecurity"	"Ze względów bezpieczeństwa musisz ponownie wpisać hasło, aby kontynuować."
"[english]Steam_RefreshLogin_PurchaseSecurity"	"For security reasons, it is required that you re-enter your password to continue."
"Steam_AccountAlreadyLoggedInNeedShutdown"	"Twoje konto „{s:accountname}” jest obecnie używane na innym komputerze.\nNależy najpierw zamknąć Steam na innym komputerze, aby móc się zalogować z tego stanowiska."
"[english]Steam_AccountAlreadyLoggedInNeedShutdown"	"Your account '{s:accountname}' is currently in use at another machine.\nYou'll need to shut down Steam on your other computer in order to log in here."
"Steam_AccountAlreadyLoggedInNeedPassword"	"To konto jest aktualnie używane w innym miejscu.\nWprowadź ponownie hasło, aby zalogować się na tym komputerze."
"[english]Steam_AccountAlreadyLoggedInNeedPassword"	"This account is currently logged in elsewhere.\nRe-enter your password to login on this computer."
"Steam_ErrorLoginFailed"	"Logowanie do Steam nie powiodło się.\nPodane konto nie istnieje lub hasło było niepoprawne.\nSprawdź nazwę konta oraz hasło i spróbuj ponownie."
"[english]Steam_ErrorLoginFailed"	"Login to Steam failed.\nEither the specified account does not exist, or the password was wrong.\nPlease check your account name and password and try again."
"Notification_RefreshLogin"	"To konto jest aktualnie używane w innym miejscu."
"[english]Notification_RefreshLogin"	"This account is logged in elsewhere."
"Store_FeaturedDiscount"	"{i:featured_discount_pct}%"
"[english]Store_FeaturedDiscount"	"{i:featured_discount_pct}%"
"Store_AppDlc_Title"	"DLC dla {s:game_name}"
"[english]Store_AppDlc_Title"	"DLC for {s:game_name}"
"Library_Details_Guides"	"PORADNIKI"
"[english]Library_Details_Guides"	"GUIDES"
"Library_Details_ViewAllGuides"	"ZOBACZ WSZYSTKIE"
"[english]Library_Details_ViewAllGuides"	"VIEW ALL"
"Library_Details_Guides_Favorited"	"W ULUBIONYCH"
"[english]Library_Details_Guides_Favorited"	"IN YOUR FAVORITES"
"Library_Details_Guides_Popular"	"POPULARNE"
"[english]Library_Details_Guides_Popular"	"POPULAR"
"Steam_DeleteApplicationConfirmation_Text"	"Usunie to wszelką zawartość {s:gamename} z tego komputera.\n\nAplikacja pozostanie w Bibliotece, ale aby użyć jej w przyszłości, musisz najpierw ponownie pobrać jej zawartość."
"[english]Steam_DeleteApplicationConfirmation_Text"	"This will delete all {s:gamename} content from this computer.\n\nThe application will remain in your Library, but to run it in the future you'll have to re-download its content."
"Checkout_Error"	"Wystąpił błąd. Spróbuj ponownie."
"[english]Checkout_Error"	"An error occurred. Please try again."
"Checkout_AddFunds_Title"	"Dodaj fundusze do swojego portfela"
"[english]Checkout_AddFunds_Title"	"Add funds to your wallet"
"Checkout_AddFunds_Description"	"Fundusze w twoim portfelu Steam mogą posłużyć do zakupu dowolnej gry na Steam lub do płatności w grach, które obsługują transakcje Steam."
"[english]Checkout_AddFunds_Description"	"Funds in your Steam Wallet may be used for the purchase of any game on Steam or within a game that supports Steam transactions."
"Checkout_AddFunds_Minimum"	"Wymagane minimum"
"[english]Checkout_AddFunds_Minimum"	"Minimum Required"
"Checkout_AddFunds_AddAmount"	"Dodaj {s:amount}"
"[english]Checkout_AddFunds_AddAmount"	"Add {s:amount}"
"Friends_Chat_SendOfflineMessage"	"{s:chatfriendname} jest obecnie offline. Otrzyma twoją wiadomość niezwłocznie po tym, jak tylko się zaloguje."
"[english]Friends_Chat_SendOfflineMessage"	"{s:chatfriendname} is currently offline, they will receieve your message the next time they log in."
"Quit_ExitBigPicture"	"Wróć do pulpitu"
"[english]Quit_ExitBigPicture"	"Return to Desktop"
"Quit_ExitSteam"	"Wyjdź ze Steam"
"[english]Quit_ExitSteam"	"Exit Steam"
"Quit_ChangeUser"	"Zmień użytkownika..."
"[english]Quit_ChangeUser"	"Change User..."
"Quit_GoOffline"	"Przejdź w tryb offline..."
"[english]Quit_GoOffline"	"Go Offline..."
"Quit_GoOnline"	"Przejdź w tryb online..."
"[english]Quit_GoOnline"	"Go Online..."
"Quit_Shutdown"	"Wyłącz"
"[english]Quit_Shutdown"	"Shutdown"
"Quit_Restart"	"Uruchom ponownie"
"[english]Quit_Restart"	"Restart"
"Quit_Sleep"	"Uśpij"
"[english]Quit_Sleep"	"Sleep"
"Checkout_MicroTxnAuth_Title"	"Transakcja Steam"
"[english]Checkout_MicroTxnAuth_Title"	"Steam Transaction"
"Checkout_MicroTxnAuth_Description"	"{s:game} prosi o autoryzację następującej transakcji"
"[english]Checkout_MicroTxnAuth_Description"	"{s:game} has requested authorization for the following transaction."
"Checkout_MicroTxnAuth_AddFunds"	"Dodaj fundusze"
"[english]Checkout_MicroTxnAuth_AddFunds"	"Add funds"
"Checkout_MicroTxnAuth_Approve"	"Potwierdź transakcję"
"[english]Checkout_MicroTxnAuth_Approve"	"Approve transaction"
"Checkout_MicroTxnAuth_Cancel"	"Anuluj transakcję"
"[english]Checkout_MicroTxnAuth_Cancel"	"Cancel transaction"
"Checkout_MicroTxnAuth_Error"	"Napotkano błąd podczas wczytywania informacji o transakcji Steam dla tej gry. Spróbuj ponownie."
"[english]Checkout_MicroTxnAuth_Error"	"An error occurred while loading the Steam transaction information for this game. Please try again."
"Checkout_MicroTxnAuth_Quantity"	"LICZBA {i:quantity}"
"[english]Checkout_MicroTxnAuth_Quantity"	"QTY {i:quantity}"
"Checkout_YourWallet"	"Twój portfel"
"[english]Checkout_YourWallet"	"Your wallet"
"Checkout_WalletCredit"	"Zostanie dodane do twojego Portfela Steam"
"[english]Checkout_WalletCredit"	"To be added to your Steam Wallet"
"Checkout_Confirmation_FundsAdded"	"Twoje fundusze są dostępne od użycia natychmiastowo, a paragon zostanie wkrótce do ciebie wysłany e-mailem."
"[english]Checkout_Confirmation_FundsAdded"	"Your funds are available for use immediately, and a receipt will be emailed to you shortly."
"Checkout_Confirmation_ReturnTransaction"	"Wróć do swojej transakcji"
"[english]Checkout_Confirmation_ReturnTransaction"	"Return to your transaction"
"Checkout_Review_SecurityCode"	"Kod bezpieczeństwa dla {s:payment_method_cvv}"
"[english]Checkout_Review_SecurityCode"	"Security code for {s:payment_method_cvv}"
"Tenfoot_InstallServiceTitle"	"Instalowanie usługi Steam"
"[english]Tenfoot_InstallServiceTitle"	"Installing Steam Service"
"Tenfoot_InstallServiceText"	"Aby uruchomić poprawnie Steam na tej wersji systemu Windows, potrzebne jest zainstalowanie komponentu usługi Steam.\n\nProces instalacji usługi wymaga posiadania praw administratora."
"[english]Tenfoot_InstallServiceText"	"In order to run Steam properly on this version of Windows, the Steam service component must be installed.\n\nThe service installation process requires administrator privileges."
"Tenfoot_InstallServiceOk"	"ZAINSTALUJ USŁUGĘ"
"[english]Tenfoot_InstallServiceOk"	"INSTALL SERVICE"
"Tenfoot_InstallServiceCancel"	"ANULUJ"
"[english]Tenfoot_InstallServiceCancel"	"CANCEL"
"SteamUI_DownloadsDisabled_Title"	"Pobieranie wyłączone"
"[english]SteamUI_DownloadsDisabled_Title"	"Downloads Disabled"
"Steam_CannotInstallDownloadsDisabled"	"Gry nie mogą zostać zainstalowane, gdy pobieranie jest wyłączone.\n"
"[english]Steam_CannotInstallDownloadsDisabled"	"Games cannot be installed when downloads are disabled.\n"
"Steam_AppUpdateError_29"	"niewłaściwa platforma"
"[english]Steam_AppUpdateError_29"	"invalid platform"
"Steam_AppUpdateError_30"	"niewspierany system plików"
"[english]Steam_AppUpdateError_30"	"unsupported filesystem"
"Steam_AppUpdateError_31"	"uszkodzone pliki aktualizacji"
"[english]Steam_AppUpdateError_31"	"corrupt update files"
"Steam_AppUpdateError_32"	"pobieranie wyłączone"
"[english]Steam_AppUpdateError_32"	"downloads disabled"
"Quit_StopStreaming"	"Zatrzymaj streaming"
"[english]Quit_StopStreaming"	"Stop Streaming"
"Library_Details_Renew"	"ODNÓW"
"[english]Library_Details_Renew"	"RENEW"
"UI_Agreements"	"Uzgodnienia"
"[english]UI_Agreements"	"Agreements"
"UI_ViewAgreements"	"Zobacz UUS i politykę prywatności"
"[english]UI_ViewAgreements"	"View SSA and Privacy Policy"
"UI_I_Agree"	"Zgadzam się"
"[english]UI_I_Agree"	"I agree"
"Login_CapsLockWarning"	"CAPS LOCK WŁĄCZONY"
"[english]Login_CapsLockWarning"	"CAPS LOCK ON"
"Login_Password_CapsLock"	"HASŁO / CAPS LOCK WŁĄCZONY"
"[english]Login_Password_CapsLock"	"PASSWORD / CAPS LOCK ON"
"Settings_Network"	"Sieć"
"[english]Settings_Network"	"Network"
"SettingsNetwork_Intro"	"Skonfiguruj swoje ustawienia sieci"
"[english]SettingsNetwork_Intro"	"Configure your network settings"
"SettingsNetwork_SelectNetwork"	"Wybierz sieć"
"[english]SettingsNetwork_SelectNetwork"	"Select a Network"
"SettingsNetwork_NetworkPassword"	"Hasło sieci"
"[english]SettingsNetwork_NetworkPassword"	"Network Password"
"SettingsNetwork_WiredConnection"	"Połączenie kablowe"
"[english]SettingsNetwork_WiredConnection"	"Wired Connection"
"SettingsNetwork_Connect"	"Połącz"
"[english]SettingsNetwork_Connect"	"Connect"
"SettingsNetwork_Connected"	"Połączono"
"[english]SettingsNetwork_Connected"	"Connected"
"SettingsNetwork_Connecting"	"Łączenie..."
"[english]SettingsNetwork_Connecting"	"Connecting..."
"Library_Details_Controller"	"KONTROLERY"
"[english]Library_Details_Controller"	"CONTROLLERS"
"Library_Details_ViewControllerDetails"	"SZCZEGÓŁY KONTROLERA"
"[english]Library_Details_ViewControllerDetails"	"CONTROLLER DETAILS"
"Library_Details_Controller_Controller1"	"Kontroler pierwszy"
"[english]Library_Details_Controller_Controller1"	"Controller One"
"Library_Details_Controller_Controller2"	"Kontroler drugi"
"[english]Library_Details_Controller_Controller2"	"Controller Two"
"Library_Details_Controller_Controller3"	"Kontroler trzeci"
"[english]Library_Details_Controller_Controller3"	"Controller Three"
"Library_Details_Controller_Controller4"	"Kontroler czwarty"
"[english]Library_Details_Controller_Controller4"	"Controller Four"
"Library_Details_Controller_Controller5"	"Kontroler piąty"
"[english]Library_Details_Controller_Controller5"	"Controller Five"
"Library_Details_Controller_Controller6"	"Kontroler szósty"
"[english]Library_Details_Controller_Controller6"	"Controller Six"
"Library_Details_Controller_Controller7"	"Kontroler siódmy"
"[english]Library_Details_Controller_Controller7"	"Controller Seven"
"Library_Details_Controller_Controller8"	"Kontroler ósmy"
"[english]Library_Details_Controller_Controller8"	"Controller Eight"
"Library_Details_Controller_PlayerAssigned"	"{s:controller_player}"
"[english]Library_Details_Controller_PlayerAssigned"	"{s:controller_player}"
"Library_Details_CancelControllerDetails"	"ANULUJ"
"[english]Library_Details_CancelControllerDetails"	"CANCEL"
"Library_ControllerBindingsTitle"	"Skróty klawiaturowe w {s:gamename}"
"[english]Library_ControllerBindingsTitle"	"{s:gamename} Bindings"
"Library_AddContent_Activate"	"Aktywuj produkt na Steam..."
"[english]Library_AddContent_Activate"	"Activate a Product on Steam..."
"Library_AddContent_Store"	"Przeglądaj Sklep Steam pod kątem gier..."
"[english]Library_AddContent_Store"	"Browse the Steam Store for Games..."
"Library_ActivateProduct_Title"	"Aktywuj produkt"
"[english]Library_ActivateProduct_Title"	"Activate a product"
"Library_ActivateProduct_Intro"	"Aby zarejestrować produkt w systemie Steam, wpisz kod produktu znajdujący się na płycie CD/DVD lub kod innego produktu Steam."
"[english]Library_ActivateProduct_Intro"	"To register your product with Steam, enter the product code distributed with a retail CD/DVD or other Steam product key here."
"Library_ActivateProduct_CodeLabel"	"Kod produktu"
"[english]Library_ActivateProduct_CodeLabel"	"Product code"
"Library_ActivateProduct_AgreementDesc"	"Aktywując produkt, zgadzasz się z warunkami Umowy użytkownika Steam i polityką prywatności."
"[english]Library_ActivateProduct_AgreementDesc"	"By activating a product you agree to the Steam Subscriber Agreement and Privacy Policy."
"Library_ActivateProduct_Activate"	"ZGADZAM SIĘ, AKTYWUJ"
"[english]Library_ActivateProduct_Activate"	"I AGREE, ACTIVATE"
"Activate_SubscriptionSuccess_Headline"	"Aktywacja powiodła się!"
"[english]Activate_SubscriptionSuccess_Headline"	"Activation Successful!"
"Activate_SubscriptionSuccess"	"Twój kod produktu został pomyślnie aktywowany. Produkt ten jest teraz trwale powiązany z twoim kontem Steam. Musisz się zalogować na to konto, aby mieć dostęp do elementów, które właśnie aktywowano w Steam."
"[english]Activate_SubscriptionSuccess"	"Your product activation code has successfully been activated. This product or products are now permanently associated with your Steam account. You must login to this account to have access to the items you've just activated on Steam."
"Activate_SubscriptionSuccess_Promo_Headline"	"Aktywacja powiodła się!"
"[english]Activate_SubscriptionSuccess_Promo_Headline"	"Activation Successful!"
"Activate_SubscriptionSuccess_Promo"	"Twój kod promocyjny do {s:subscription} został pomyślnie aktywowany. Zawartość będzie dostępna dla ciebie po pełnej aktywacji produktu na Steam. Produkt ten jest teraz trwale powiązany z twoim kontem Steam. Musisz się zalogować na to konto, aby mieć dostęp do elementów, które właśnie aktywowano w Steam."
"[english]Activate_SubscriptionSuccess_Promo"	"Your {s:subscription} promotion code has successfully been activated. This content will become available to you once you've activated the full game on Steam. This content is now permanently associated with your Steam account. You must login to this account to have access to the items you've just activated on Steam."
"Activate_InvalidCode_Headline"	"Niepoprawny kod produktu"
"[english]Activate_InvalidCode_Headline"	"Invalid Product Code"
"Activate_InvalidCode"	"Podany kod produktu jest niepoprawny.\n\nSprawdź, czy wszystkie znaki zostały poprawnie wpisane.\nI, L, i 1 mogą wyglądać podobnie, tak samo jak V i Y oraz 0 i O."
"[english]Activate_InvalidCode"	"The product code you've entered is not valid. \n\nPlease double check to see if you've mistyped your key.\nI, L, and 1 can look alike, as can V and Y, and 0 and O."
"Activate_ServiceUnavailable_Headline"	"Serwery Steam są niedostępne"
"[english]Activate_ServiceUnavailable_Headline"	"Steam Server Is Unavailable"
"Activate_ServiceUnavailable"	"Twój komputer nie może połączyć się z serwerami Steam lub usługa może być tymczasowo niedostępna. Spróbuj ponownie później."
"[english]Activate_ServiceUnavailable"	"Your computer is either currently unable to reach the Steam servers, or the service may be temporarily disabled. Please try again later."
"Activate_ContactSupport_Headline"	"Błąd zakupu"
"[english]Activate_ContactSupport_Headline"	"Purchase Error"
"Activate_ContactSupport"	"Wystąpił niespodziewany błąd. Twoja subskrypcja do {s:subscription} nie została zakończona. \n\nSkontaktuj się z pomocą techniczną Steam."
"[english]Activate_ContactSupport"	"An unexpected error has occurred. Your subscription to {s:subscription} has not been completed. \n\nPlease contact Steam Support."
"Activate_Subscription_Rejected_Headline"	"Duplikat kodu produktu"
"[english]Activate_Subscription_Rejected_Headline"	"Duplicate Product Code"
"Activate_Subscription_Rejected"	"Podany kod produktu jest niepoprawny, ponieważ został już aktywowany na innym koncie Steam. Aktywacja produktu {s:subscription} nie została sfinalizowana."
"[english]Activate_Subscription_Rejected"	"The product code you've entered has already been activated by an existing Steam account, and is therefore invalid. Your activation of {s:subscription} has not been completed."
"Activate_AlreadyPurchased_Headline"	"Już posiadasz ten produkt"
"[english]Activate_AlreadyPurchased_Headline"	"Product Already Owned"
"Activate_AlreadyPurchased"	"Na koncie Steam zarejestrowany/e jest/są już produkt(y) związany/e z tym kodem aktywacyjnym. Kliknij OK, aby przejść do instalacji."
"[english]Activate_AlreadyPurchased"	"This Steam account already owns the product(s) associated with this activation code. Click OK to proceed to installation."
"Activate_RateLimited_Headline"	"Zbyt wiele prób aktywacji"
"[english]Activate_RateLimited_Headline"	"Too Many Activation Attempts"
"Activate_RateLimited"	"Odnotowaliśmy zbyt wiele nieudanych prób aktywacji z tego konta. Poczekaj i spróbuj później ponownie użyć swojego kodu produktu."
"[english]Activate_RateLimited"	"There have been too many recent unsuccessful activation attempts from this account. Please wait and try your product code again later."
"Activate_RestrictedCountry_Headline"	"Niedostępna"
"[english]Activate_RestrictedCountry_Headline"	"Not Available"
"Activate_RestrictedCountry"	"Przepraszamy, ale {s:subscription} jest niedostępne w tym kraju. Twoje zamówienie zostało anulowane."
"[english]Activate_RestrictedCountry"	"Sorry, but {s:subscription} is not available for purchase in this country. Your purchase has been cancelled."
"Activate_MustOwnOtherApp_Headline"	"Najpierw należy aktywować oryginalną grę"
"[english]Activate_MustOwnOtherApp_Headline"	"Please First Activate the Original Game"
"Activate_MustOwnOtherApp"	"Wprowadzony kod produktu wymaga posiadania innego produktu w celu umożliwienia aktywacji.\n\nJeśli próbujesz aktywować pakiet rozszerzeń lub pobraną zawartość, należy najpierw aktywować oryginalną grę, a następnie dodatkową zawartość."
"[english]Activate_MustOwnOtherApp"	"The product code you've entered requires ownership of another product before activation.\n\nIf you are trying to activate an expansion pack or downloadable content, please first activate the original game, then activate this additional content."
"Activate_MustLoginPS3_Headline"	"Użytkownik nie grał w {s:gamename} na konsoli PlayStation®3"
"[english]Activate_MustLoginPS3_Headline"	"Your account has not played {s:gamename} on the PlayStation®3 system"
"Activate_MustLoginPS3"	"Wprowadzony przez ciebie kod produktu wymaga najpierw uruchomienia {s:gamename} na konsoli PlayStation®3.\n\nWykonaj następujące kroki:\n\n- Uruchom {s:gamename} na swojej konsoli PlayStation®3\n\n- Połącz konto Steam ze swoim kontem PlayStation®3 Network\n\n- Połącz się ze Steam podczas gry w {s:gamename} na PlayStation®3\n\n- Aktywuj kod produktu w Steam"
"[english]Activate_MustLoginPS3"	"The product code you have entered requires that you first play {s:gamename} on the PlayStation®3 system before it can be registered.\n\nPlease:\n\n- Start {s:gamename} on your PlayStation®3 system\n\n- Link your Steam account to your PlayStation®3 Network account\n\n- Connect to Steam while playing {s:gamename} on the PlayStation®3 system\n\n- Register this product code through Steam"
"Checkout_MicroTxnSubscription"	"Twoja kwota obciążenia wyniesie {m:cost} co {d:frequency} {s:time} {s:acct}"
"[english]Checkout_MicroTxnSubscription"	"You will be charged {m:cost} every {d:frequency} {s:time} {s:acct}"
"Checkout_MicroTxnGameSubscription"	"jak określono przez twoje konto gry"
"[english]Checkout_MicroTxnGameSubscription"	"as determined by your game account"
"Checkout_MicroTxnSubscriptionYears"	"rok/lat(a)"
"[english]Checkout_MicroTxnSubscriptionYears"	"year(s)"
"Checkout_MicroTxnSubscriptionMonths"	"mies."
"[english]Checkout_MicroTxnSubscriptionMonths"	"month(s)"
"Checkout_MicroTxnSubscriptionWeeks"	"tydz./tyg."
"[english]Checkout_MicroTxnSubscriptionWeeks"	"week(s)"
"Checkout_MicroTxnSubscriptionDays"	"dni"
"[english]Checkout_MicroTxnSubscriptionDays"	"day(s)"
"Join_Login"	"Zaloguj"
"[english]Join_Login"	"Login"
"Join_Join"	"Dołącz"
"[english]Join_Join"	"Join"
"Join_Select"	"WYBIERZ"
"[english]Join_Select"	"SELECT"
"Login_WrongPasswordOnly"	"Sprawdź swoje hasło i spróbuj ponownie."
"[english]Login_WrongPasswordOnly"	"Please check your password and try again."
"Login_AccountSuspendedSmaller"	"To konto zostało zawieszone. Skontaktuj się z pomocą techniczną Steam, aby rozwiązać ten problem."
"[english]Login_AccountSuspendedSmaller"	"Steam Support has suspended this account. Please contact Steam Support to resolve this issue."
"Login_More"	"WIĘCEJ"
"[english]Login_More"	"MORE"
"Login_Less"	"WSTECZ"
"[english]Login_Less"	"BACK"
"Login_Select"	"WYBIERZ"
"[english]Login_Select"	"SELECT"
"Login_RemoveUser"	"Usuń {s:accountname}"
"[english]Login_RemoveUser"	"Remove {s:accountname}"
"Login_AutoLogin"	"ZALOGUJ AUTOMATYCZNIE JAKO {s:accountname}"
"[english]Login_AutoLogin"	"AUTO-LOGIN AS {s:accountname}"
"Login_UserPersonaName"	"{s:personaname}"
"[english]Login_UserPersonaName"	"{s:personaname}"
"Login_UserAccountName"	"{s:accountname}"
"[english]Login_UserAccountName"	"{s:accountname}"
"SettingsNetwork_ShowPassword"	"Pokaż hasło"
"[english]SettingsNetwork_ShowPassword"	"Show Password"
"SettingsNetwork_Disconnect"	"Rozłącz"
"[english]SettingsNetwork_Disconnect"	"Disconnect"
"SettingsNetwork_Disconnected"	"Rozłączono"
"[english]SettingsNetwork_Disconnected"	"Disconnected"
"SettingsNetwork_Disconnecting"	"Rozłączanie..."
"[english]SettingsNetwork_Disconnecting"	"Disconnecting..."
"SettingsNetwork_Retrying"	"Ponawianie próby..."
"[english]SettingsNetwork_Retrying"	"Retrying..."
"Store_AppPurchaseOptions_TitleNoCount"	"Opcje zakupu"
"[english]Store_AppPurchaseOptions_TitleNoCount"	"Purchase Options"
"Library_Details_ControllerChooseBinding"	"PRZEGLĄDAJ"
"[english]Library_Details_ControllerChooseBinding"	"BROWSE"
"Library_Details_ControllerEditBinding"	"MODYFIKUJ"
"[english]Library_Details_ControllerEditBinding"	"MODIFY"
"Library_Details_ControllerUseBinding"	"UŻYJ"
"[english]Library_Details_ControllerUseBinding"	"USE"
"Library_Details_ControllerRecentBindings"	"MOJE USTAWIENIA PRZYCISKÓW"
"[english]Library_Details_ControllerRecentBindings"	"MY BINDINGS"
"Library_Details_ControllerCommunityBindings"	"USTAWIENIE PRZYCISKÓW SPOŁECZNOŚCI"
"[english]Library_Details_ControllerCommunityBindings"	"COMMUNITY BINDINGS"
"Library_Details_ControllerBindingDescription"	"UWAGI AUTORA"
"[english]Library_Details_ControllerBindingDescription"	"AUTHOR'S NOTES"
"Library_Details_ControllerDefaultBinding"	"Domyślne"
"[english]Library_Details_ControllerDefaultBinding"	"Defaults"
"Checkout_Review_Update_Billing_Info_Title"	"Zapisz"
"[english]Checkout_Review_Update_Billing_Info_Title"	"Save"
"Checkout_Review_Update_Billing_Info_Continue_Button"	"Zapisz"
"[english]Checkout_Review_Update_Billing_Info_Continue_Button"	"Save"
"Checkout_Confirmation_Update_Billing_Info_Title"	"Informacje dotyczące płatności zostały zapisane!"
"[english]Checkout_Confirmation_Update_Billing_Info_Title"	"Your Billing Info Has Been Saved!"
"Checkout_Confirmation_Update_Billing_Info_Description"	"Informacje dotyczące płatności zostały zapisane dla przyszłych zakupów."
"[english]Checkout_Confirmation_Update_Billing_Info_Description"	"Your billing information has now been saved for future purchases."
"Checkout_MicroTxnAuth_UpdateBillingInfo"	"Aktualizuj informacje dotyczące płatności"
"[english]Checkout_MicroTxnAuth_UpdateBillingInfo"	"Update Billing Info"
"Library_Details_CloseControllerDetails"	"ZAMKNIJ"
"[english]Library_Details_CloseControllerDetails"	"CLOSE"
"Library_Details_ControllerDoneEditing"	"ZAPISZ"
"[english]Library_Details_ControllerDoneEditing"	"SAVE"
"Library_Details_SelectYourBindingFor"	"WYBIERZ FUNKCJĘ DLA"
"[english]Library_Details_SelectYourBindingFor"	"SELECT BINDING FOR"
"Library_Details_SaveBindingDescription"	"GOTOWE"
"[english]Library_Details_SaveBindingDescription"	"DONE"
"Login_RemoveUserTitle"	"Usuń {s:accountname}"
"[english]Login_RemoveUserTitle"	"Remove {s:accountname}"
"Login_RemoveUserDescription"	"Czy na pewno chcesz usunąć {s:accountname}?"
"[english]Login_RemoveUserDescription"	"Are you sure you'd like to remove {s:accountname}?"
"WizardButton_Next"	"Dalej"
"[english]WizardButton_Next"	"Next"
"WizardButton_Back"	"Wstecz"
"[english]WizardButton_Back"	"Back"
"WizardButton_Cancel"	"Anuluj"
"[english]WizardButton_Cancel"	"Cancel"
"WizardButton_Done"	"Gotowe"
"[english]WizardButton_Done"	"Done"
"CreateAccount_ServiceUnavailable"	"Twój komputer nie może połączyć się z serwerami Steam lub usługa może być tymczasowo niedostępna. Spróbuj ponownie później."
"[english]CreateAccount_ServiceUnavailable"	"Your computer is either currently unable to reach the Steam servers, or the service may be temporarily disabled. Please try again later."
"CreateAccount_NextField"	"DALEJ"
"[english]CreateAccount_NextField"	"NEXT"
"CreateAccount_Cancel_Title"	"Utwórz konto"
"[english]CreateAccount_Cancel_Title"	"Create Account"
"CreateAccount_Cancel_Description"	"Czy na pewno chcesz anulować tworzenie konta?"
"[english]CreateAccount_Cancel_Description"	"Are you sure you'd like to cancel creating this account?"
"CreateAccount_Credentials_Title"	"Witaj"
"[english]CreateAccount_Credentials_Title"	"Hello,"
"CreateAccount_Credentials_Description"	"Tworzenie konta Steam to tylko kilka prostych kroków.\nZatem zaczynajmy."
"[english]CreateAccount_Credentials_Description"	"Creating a Steam account takes just a few simple steps.\nLet's get started."
"CreateAccount_Credentials_AgeLimitNext"	"Mam 13 lub więcej lat"
"[english]CreateAccount_Credentials_AgeLimitNext"	"I am 13 years old, or older"
"CreateAccount_Credentials_AccountName"	"Nazwa konta"
"[english]CreateAccount_Credentials_AccountName"	"Account Name"
"CreateAccount_Credentials_Password"	"Hasło"
"[english]CreateAccount_Credentials_Password"	"Password"
"CreateAccount_Credentials_PasswordAgain"	"Powtórz hasło"
"[english]CreateAccount_Credentials_PasswordAgain"	"Password, again"
"CreateAccount_Credentials_AvailableAccountNames"	"Dostępne nazwy konta"
"[english]CreateAccount_Credentials_AvailableAccountNames"	"Available account names"
"CreateAccount_Credentials_AccountNameTooShort"	"Nazwa twojego konta musi zawierać co najmniej 3 znaki."
"[english]CreateAccount_Credentials_AccountNameTooShort"	"Your account name must be at least 3 characters long."
"CreateAccount_Credentials_AccountNameInvalidCharacters"	"Nazwa twojego konta zawiera niedozwolone znaki. Dozwolone znaki to litery, cyfry oraz _."
"[english]CreateAccount_Credentials_AccountNameInvalidCharacters"	"Your account name contains invalid characters. Only letters, numbers and _ are allowed."
"CreateAccount_Credentials_AccountNameInvalidSpaces"	"Nazwa twojego konta nie może zawierać żadnych spacji."
"[english]CreateAccount_Credentials_AccountNameInvalidSpaces"	"Your account name may not contain any spaces."
"CreateAccount_Credentials_AccountNameTooLong"	"Nazwa twojego konta może zawierać maksymalnie 64 znaki."
"[english]CreateAccount_Credentials_AccountNameTooLong"	"Your account name must be less than 64 characters long."
"CreateAccount_Credentials_AccountNameReserved"	"Nazwa twojego konta nie może zawierać słów  „Valve” bądź  „Steam”."
"[english]CreateAccount_Credentials_AccountNameReserved"	"Your account name may not contain 'Valve' or 'Steam'."
"CreateAccount_Credentials_AccountNameTaken"	"Niestety, wybrana nazwa konta jest niedostępna. Spróbuj ponownie bądź wybierz nazwę spośród proponowanych poniżej."
"[english]CreateAccount_Credentials_AccountNameTaken"	"Sadly, this account name is unavailable. Please try again or select one of the available names below."
"CreateAccount_Credentials_AccountNameCheckingAvailability"	"Sprawdzanie dostępności tej nazwy konta..."
"[english]CreateAccount_Credentials_AccountNameCheckingAvailability"	"Checking availability of this account name..."
"CreateAccount_Credentials_PasswordContainsAccountName"	"Twoje hasło zawiera nazwę twojego konta."
"[english]CreateAccount_Credentials_PasswordContainsAccountName"	"Your password contains your account name."
"CreateAccount_Credentials_PasswordTooWeak"	"Twoje hasło jest zbyt słabe."
"[english]CreateAccount_Credentials_PasswordTooWeak"	"Your password is too weak."
"CreateAccount_Credentials_PasswordsDontMatch"	"Wprowadzone hasła nie są jednakowe. Wprowadź to samo hasło w obydwa pola."
"[english]CreateAccount_Credentials_PasswordsDontMatch"	"The passwords you entered do not match. Please enter the same password in each field."
"CreateAccount_Credentials_PasswordLessMinimumLength"	"Twoje hasło musi zawierać co najmniej 8 znaków."
"[english]CreateAccount_Credentials_PasswordLessMinimumLength"	"Your password must be at least 8 characters long."
"CreateAccount_Credentials_PasswordMoreMaximumLength"	"Twoje hasło może zawierać maksymalnie 64 znaki."
"[english]CreateAccount_Credentials_PasswordMoreMaximumLength"	"Your password must be less than 64 characters long."
"CreateAccount_Credentials_Weak"	"Słabe"
"[english]CreateAccount_Credentials_Weak"	"Weak"
"CreateAccount_Credentials_Alright"	"W porządku"
"[english]CreateAccount_Credentials_Alright"	"Alright"
"CreateAccount_Credentials_Strong"	"Mocne"
"[english]CreateAccount_Credentials_Strong"	"Strong"
"CreateAccount_Credentials_TooShort"	"Zbyt krótkie"
"[english]CreateAccount_Credentials_TooShort"	"Too short"
"CreateAccount_Email_Title"	"W jaki sposób możemy się z tobą skontaktować?"
"[english]CreateAccount_Email_Title"	"How may we contact you?"
"CreateAccount_Email_Description"	"Jeśli zapomnisz hasła lub będziemy musieli zweryfikować twoje konto,\njak mamy się z tobą skontaktować?"
"[english]CreateAccount_Email_Description"	"If you forget your password or we need to verify your account,\nhow may we contact you?"
"CreateAccount_Email_EmailAddress"	"Adres e-mail"
"[english]CreateAccount_Email_EmailAddress"	"Email address"
"CreateAccount_Email_EmailAddressAgain"	"Powtórz adres e-mail"
"[english]CreateAccount_Email_EmailAddressAgain"	"Email address, one more time"
"CreateAccount_Email_Invalid"	"Wymagany jest działający adres e-mail."
"[english]CreateAccount_Email_Invalid"	"A valid email address is required."
"CreateAccount_Email_DontMatch"	"Podany adres e-mail nie pasuje. Należy wpisać ten sam adres w obu polach."
"[english]CreateAccount_Email_DontMatch"	"The email addresses you entered do not match. Please enter the same email address in each field."
"CreateAccount_Email_CheckingIfUsed"	"Sprawdzanie, czy podany adres e-mail nie został już kiedyś użyty..."
"[english]CreateAccount_Email_CheckingIfUsed"	"Checking to see if this email address is already in use..."
"CreateAccount_EmailTaken_Title"	"Poczekaj."
"[english]CreateAccount_EmailTaken_Title"	"Hold up."
"CreateAccount_EmailTaken_Description"	"Konto z podanym adresem e-mail już istnieje.\n\nJeśli posiadasz założone wcześniej konto Steam, zaloguj się na nie zamiast zakładać nowe."
"[english]CreateAccount_EmailTaken_Description"	"An account with this email address already exists.\n\nIf you have previously created a Steam account, you should log into it rather than create a new one."
"CreateAccount_EmailTaken_EnterNewAddress"	"Wprowadź nowy adres"
"[english]CreateAccount_EmailTaken_EnterNewAddress"	"Enter new address"
"CreateAccount_EmailTaken_CreateAccountAnyway"	"Mimo to stwórz nowe konto"
"[english]CreateAccount_EmailTaken_CreateAccountAnyway"	"Create new account anyway"
"CreateAccount_Agreements_Title"	"Kilka ważnych szczegółów."
"[english]CreateAccount_Agreements_Title"	"A few important details."
"CreateAccount_Agreements_Description"	"Poprzez utworzenie konta Steam zgadzasz się na warunki umowy subskrybenta Steam oraz politykę prywatności."
"[english]CreateAccount_Agreements_Description"	"By creating a Steam account, you agree to the Steam Subscriber Agreement and Privacy Policy."
"CreateAccount_Agreements_IAgree"	"Zgadzam się"
"[english]CreateAccount_Agreements_IAgree"	"I agree"
"CreateAccount_Agreements_Agreements"	"Umowy"
"[english]CreateAccount_Agreements_Agreements"	"Agreements"
"CreateAccount_Agreements_ViewSSAAndPPA"	"Wyświetl umowę subskrybenta Steam (SSA) oraz politykę prywatności"
"[english]CreateAccount_Agreements_ViewSSAAndPPA"	"View SSA & Privacy Policy"
"CreateAccount_SSA_Title"	"Umowa Użytkownika Steam"
"[english]CreateAccount_SSA_Title"	"Steam Subscriber Agreement"
"CreateAccount_SSA_ViewPPA"	"Zobacz Politykę Prywatności"
"[english]CreateAccount_SSA_ViewPPA"	"View Privacy Policy"
"CreateAccount_PPA_Title"	"Polityka Prywatności Steam"
"[english]CreateAccount_PPA_Title"	"Steam Privacy Policy"
"CreateAccount_PPA_ViewSSA"	"Zobacz Umowę Użytkownika Steam"
"[english]CreateAccount_PPA_ViewSSA"	"View Steam Subscriber Agreement"
"CreateAccount_Creating_Title"	"Już prawie..."
"[english]CreateAccount_Creating_Title"	"Almost there..."
"CreateAccount_Creating_Description"	"Wytrzymaj jeszcze trochę - skrzętnie tworzymy twoje konto Steam."
"[english]CreateAccount_Creating_Description"	"Hang tight - we're busily creating your Steam account."
"CreateAccount_Fail_Title"	"O nie!"
"[english]CreateAccount_Fail_Title"	"Oh no!"
"CreateAccount_Fail_Description"	"Steam nie może utworzyć twojego konta."
"[english]CreateAccount_Fail_Description"	"Steam could not create your account."
"CreateAccount_Fail_PasswordIllegal"	"Twoje hasło nie spełnia dodatkowych wymogów złożoności. Spróbuj jeszcze raz z innym hasłem."
"[english]CreateAccount_Fail_PasswordIllegal"	"Your password did not pass additional complexity requirements. Please try again with a different password."
"CreateAccount_Fail_EmailInvalid"	"Twój adres e-mail jest nieważny. Spróbuj z innym adresem e-mail."
"[english]CreateAccount_Fail_EmailInvalid"	"Your email address isn't valid. Please try again with a different email address."
"CreateAccount_Fail_AccountNameInvalid"	"Nazwa twojego konta jest nieprawidłowa. Spróbuj z inną nazwą."
"[english]CreateAccount_Fail_AccountNameInvalid"	"Your account name isn't valid. Please try again with a different account name."
"CreateAccount_Fail_AccountNameInUse"	"Ta nazwa konta jest już w użyciu. Spróbuj z inną nazwą."
"[english]CreateAccount_Fail_AccountNameInUse"	"That account name is already in use. Please try again with a different account name."
"CreateAccount_Fail_TryAgain"	"Spróbuj ponownie"
"[english]CreateAccount_Fail_TryAgain"	"Try again"
"CreateAccount_Success_Title"	"Gotowe!"
"[english]CreateAccount_Success_Title"	"You're all set!"
"CreateAccount_Success_Description"	"Po prostu wpatruj się w ten monitor przez dwie minuty, by pozostawić informację wewnątrz siatkówki oka.\n\nBędziesz tego potrzebować, by mieć dostęp do swoich gier, więc nie zapomnij o tym!"
"[english]CreateAccount_Success_Description"	"Just stare at this screen for two minutes to burn the information below onto the back of your retina.\n\nYou'll need this to access your games, so don't forget it!"
"CreateAccount_Success_Show"	"Pokaż"
"[english]CreateAccount_Success_Show"	"Show"
"CreateAccount_Success_Hide"	"Ukryj"
"[english]CreateAccount_Success_Hide"	"Hide"
"CreateAccount_Success_ContactEmailAddress"	"Adres e-mail do kontaktu"
"[english]CreateAccount_Success_ContactEmailAddress"	"Contact email address"
"Settings_About"	"Więcej"
"[english]Settings_About"	"About"
"SettingsAbout_SteamClient"	"Klient Steam"
"[english]SettingsAbout_SteamClient"	"Steam Client"
"SettingsAbout_Built"	"Utworzono"
"[english]SettingsAbout_Built"	"Built"
"SettingsAbout_BuildDateTime"	"{s:build_date} o {s:build_time}"
"[english]SettingsAbout_BuildDateTime"	"{s:build_date}, at {s:build_time}"
"SettingsAbout_SteamPackage"	"Wersje Steam"
"[english]SettingsAbout_SteamPackage"	"Steam Versions"
"SettingsAbout_SteamPackageVersion"	"{s:bootstrapper_version} / {s:package_version}"
"[english]SettingsAbout_SteamPackageVersion"	"{s:bootstrapper_version} / {s:package_version}"
"SettingsAbout_SteamAPI"	"Steam API"
"[english]SettingsAbout_SteamAPI"	"Steam API"
"SettingsAbout_SteamAPIVersion"	"v{s:build_interface}"
"[english]SettingsAbout_SteamAPIVersion"	"v{s:build_interface}"
"SettingsAbout_SystemInfo"	"Informacje o systemie"
"[english]SettingsAbout_SystemInfo"	"System Info"
"SettingsAbout_CPUVendorLabel"	"Dostawca procesora"
"[english]SettingsAbout_CPUVendorLabel"	"CPU Vendor"
"SettingsAbout_CPUVendor"	"{s:cpu_vendor}"
"[english]SettingsAbout_CPUVendor"	"{s:cpu_vendor}"
"SettingsAbout_CPUSpeedLabel"	"Taktowanie procesora"
"[english]SettingsAbout_CPUSpeedLabel"	"CPU Clock"
"SettingsAbout_CPUSpeed"	"{s:cpu_speed} GHz"
"[english]SettingsAbout_CPUSpeed"	"{s:cpu_speed} GHz"
"SettingsAbout_CPUCoresLabel"	"Liczba rdzeni procesora"
"[english]SettingsAbout_CPUCoresLabel"	"CPU Cores"
"SettingsAbout_CPUCores"	"{i:cpu_cores} rdzeni, {i:cpu_threads} wątków"
"[english]SettingsAbout_CPUCores"	"{i:cpu_cores} Cores, {i:cpu_threads} Threads"
"SettingsAbout_RAMLabel"	"Pamięć systemowa"
"[english]SettingsAbout_RAMLabel"	"System Memory"
"SettingsAbout_RAM"	"{s:ram_gb} GB"
"[english]SettingsAbout_RAM"	"{s:ram_gb} GB"
"SettingsAbout_VideoCardLabel"	"Karta graficzna"
"[english]SettingsAbout_VideoCardLabel"	"Video Card"
"SettingsAbout_VideoCard"	"{s:video_card}"
"[english]SettingsAbout_VideoCard"	"{s:video_card}"
"SettingsAbout_DriverVersionLabel"	"Wersja sterownika"
"[english]SettingsAbout_DriverVersionLabel"	"Driver Version"
"SettingsAbout_DriverVersion"	"{s:video_driver_version}"
"[english]SettingsAbout_DriverVersion"	"{s:video_driver_version}"
"SettingsAbout_DriverDateLabel"	"Data sterownika"
"[english]SettingsAbout_DriverDateLabel"	"Driver Date"
"SettingsAbout_DriverDate"	"{s:video_driver_date}"
"[english]SettingsAbout_DriverDate"	"{s:video_driver_date}"
"SettingsAbout_VideoRAMLabel"	"Pamięć wideo"
"[english]SettingsAbout_VideoRAMLabel"	"Video Memory"
"SettingsAbout_VideoRAM"	"{s:vram_gb} GB"
"[english]SettingsAbout_VideoRAM"	"{s:vram_gb} GB"
"SettingsNetwork_Unplugged"	"Niepołączony"
"[english]SettingsNetwork_Unplugged"	"Unplugged"
"SettingsNetwork_Failed"	"Niepowodzenie"
"[english]SettingsNetwork_Failed"	"Failed"
"SettingsNetwork_InvalidPassword"	"Niewłaściwe hasło"
"[english]SettingsNetwork_InvalidPassword"	"Invalid Password"
"SettingsNetwork_ResetDialogInfo"	"Zrestartować tryb Big Picture teraz, by zatwierdzić twoje nowe ustawienia sieci?"
"[english]SettingsNetwork_ResetDialogInfo"	"Restart Big Picture now to apply your new network settings?"
"Checkout_Confirmation_Pending_Title"	"Transakcja jest teraz przetwarzana."
"[english]Checkout_Confirmation_Pending_Title"	"Your purchase is now pending."
"Checkout_Confirmation_Pending_Description"	"Twoja transakcja jest w toku i oczekuje na przekazanie płatności z twojego banku lub systemu płatności. Potwierdzenie transakcji może zająć kilka dni. Otrzymasz wiadomość od Valve, gdy płatność dla tej transakcji zostanie potwierdzona. Podczas tego okresu możesz kontynuować zakupy, ale nie będziesz w stanie zakupić ponownie żadnego z produktów, które oczekują na potwierdzenie płatności w tej transakcji."
"[english]Checkout_Confirmation_Pending_Description"	"Your purchase is currently in progress and is waiting for payment delivery from your processor or bank. This process can take a few days for confirmation.  Valve will send an email receipt to you when payment is received for this purchase. During this time you may continue shopping for other games, though you will not be able to re-purchase any products that are pending in this transaction."
"Library_Details_NotAvailablePlatform"	"NIEDOSTĘPNE"
"[english]Library_Details_NotAvailablePlatform"	"NOT AVAILABLE"
"Library_ControllerSaveBindingTitle"	"Zapisz ustawienia"
"[english]Library_ControllerSaveBindingTitle"	"Save Bindings"
"Library_ControllerSetTitle"	"Ustaw tytuł"
"[english]Library_ControllerSetTitle"	"Set Title"
"Library_ControllerAddDescription"	"Dodaj opis"
"[english]Library_ControllerAddDescription"	"Add Description"
"Library_ControllerSaveConfirm"	"ZAPISZ"
"[english]Library_ControllerSaveConfirm"	"SAVE"
"Library_ControllerSaveCancel"	"ANULUJ"
"[english]Library_ControllerSaveCancel"	"CANCEL"
"Library_ControllerSaveWorking"	"Praca w toku..."
"[english]Library_ControllerSaveWorking"	"Working..."
"Library_ControllerBindingErrorTitle"	"Błąd"
"[english]Library_ControllerBindingErrorTitle"	"Error"
"Library_ControllerBinding_RequireTitleError"	"Wprowadź nazwę, by zapisać te ustawienia."
"[english]Library_ControllerBinding_RequireTitleError"	"Please enter a title to save this binding set."
"Library_Controller_ControllerBindingSaveAlreadyInProgress"	"Zapisywanie ustawień zakończone niepowodzeniem, ponieważ w tle trwa już inny zapis."
"[english]Library_Controller_ControllerBindingSaveAlreadyInProgress"	"Binding save failed because another save is already in progress."
"Library_Controller_ControllerBindingFileWriteError"	"Zapisywanie ustawień na dysk zakończone niepowodzeniem."
"[english]Library_Controller_ControllerBindingFileWriteError"	"Failed writing bindings to disk."
"Library_Controller_ControllerBindingSaved"	"Zapisano ustawienia!"
"[english]Library_Controller_ControllerBindingSaved"	"Bindings are now saved!"
"Library_ControllerBindingPublic"	"Publiczny"
"[english]Library_ControllerBindingPublic"	"Public"
"Library_ControllerBindingPrivate"	"Prywatny"
"[english]Library_ControllerBindingPrivate"	"Private"
"Library_ControllerBindingsSubTitle"	"{s:binding_title}"
"[english]Library_ControllerBindingsSubTitle"	"{s:binding_title}"
"Library_ControllerBindingsSteamDefaultDescription"	"To są domyślne autoryzowane przez Steam ustawienia sterowania dla {s:gamename}. Te ustawienia wymagają niemodyfikowania w grze ustawień dla klawiatury/myszki/gamepada. Jeśli twoje ustawienia w grze różnią się od tych domyślnych, może być konieczne ich zresetowanie dla najlepszego rezultatu."
"[english]Library_ControllerBindingsSteamDefaultDescription"	"This is the default Steam authored set of bindings for {s:gamename}.  This binding requires that you have not modified the in game bindings for keyboard/mouse/gamepad.  If you have rebound keys in game you may need to reset those in game bindings for best results."
"Library_Details_ControllerBindingDescriptionBody"	"{s:binding_description}"
"[english]Library_Details_ControllerBindingDescriptionBody"	"{s:binding_description}"
"Library_ControllerBinding_DeleteTitle"	"Na pewno?"
"[english]Library_ControllerBinding_DeleteTitle"	"Are you sure?"
"Library_ControllerBinding_DeleteBody"	"Czy na pewno chcesz usunąć to ustawienie kontrolera na zawsze?"
"[english]Library_ControllerBinding_DeleteBody"	"Are you sure you want to delete this controller binding forever?"
"Library_ControllerBinding_ConfirmDelete"	"TAK"
"[english]Library_ControllerBinding_ConfirmDelete"	"YES"
"Library_ControllerBinding_CancelDelete"	"ANULUJ"
"[english]Library_ControllerBinding_CancelDelete"	"CANCEL"
"Library_Details_DeleteBinding"	"USUŃ"
"[english]Library_Details_DeleteBinding"	"DELETE"
"Library_Details_ControllerPad_EditLeft"	"SKONFIGURUJ LEWEGO PADA"
"[english]Library_Details_ControllerPad_EditLeft"	"CUSTOMIZE THE LEFT PAD"
"Library_Details_ControllerPad_EditRight"	"SKONFIGURUJ PRAWEGO PADA"
"[english]Library_Details_ControllerPad_EditRight"	"CUSTOMIZE THE RIGHT PAD"
"Library_Details_ControllerPadStyle"	"Styl wprowadzanych danych"
"[english]Library_Details_ControllerPadStyle"	"Style of Input"
"Library_Details_ControllerPad_mouse"	"Szybkość myszki"
"[english]Library_Details_ControllerPad_mouse"	"Mouse Movement"
"Library_Details_ControllerPad_4way"	"4-kierunkowe sterowanie"
"[english]Library_Details_ControllerPad_4way"	"4-Way Directional"
"Library_Details_ControllerPad_8way"	"8-kierunkowe sterowanie"
"[english]Library_Details_ControllerPad_8way"	"8-Way Directional"
"Library_Details_ControllerPadDeadZone"	"Martwa strefa"
"[english]Library_Details_ControllerPadDeadZone"	"Dead Zone"
"Library_Details_ControllerPad_10pct"	"10%"
"[english]Library_Details_ControllerPad_10pct"	"10%"
"Library_Details_ControllerPad_20pct"	"20%"
"[english]Library_Details_ControllerPad_20pct"	"20%"
"Library_Details_ControllerPad_30pct"	"30%"
"[english]Library_Details_ControllerPad_30pct"	"30%"
"Library_Details_ControllerPadBlending"	"Łączenie"
"[english]Library_Details_ControllerPadBlending"	"Blending"
"Library_Details_ControllerPad_BlendingOn"	"Włączone"
"[english]Library_Details_ControllerPad_BlendingOn"	"On"
"Library_Details_ControllerPad_BlendingOff"	"Wyłączone"
"[english]Library_Details_ControllerPad_BlendingOff"	"Off"
"Library_Details_OuterRingModifier"	"Modyfikator zewn. pierścienia"
"[english]Library_Details_OuterRingModifier"	"Outer Ring Modifier"
"Library_Details_PadClick"	"Kliknięcie pada"
"[english]Library_Details_PadClick"	"Pad Click"
"Library_Details_PadDoubleClick"	"Podw. kliknięcie pada"
"[english]Library_Details_PadDoubleClick"	"Pad Double Click"
"Library_Details_ControllerModifierNone"	"Żaden"
"[english]Library_Details_ControllerModifierNone"	"None"
"Library_Details_DoneControllerDetails"	"GOTOWE"
"[english]Library_Details_DoneControllerDetails"	"DONE"
"Library_Details_ControllerClearBinding"	"WYCZYŚĆ"
"[english]Library_Details_ControllerClearBinding"	"CLEAR"
"OOBE_WelcomeTitle"	"Witamy w Steam."
"[english]OOBE_WelcomeTitle"	"Welcome to Steam."
"OOBE_LanguageSelect"	"Ale po kolei: jakiego języka powinniśmy używać?"
"[english]OOBE_LanguageSelect"	"First things first: What language should we use?"
"Steam_AllowGameLaunch_Info"	"Pozwolić grze {s:gamename} na uruchomienie z parametrem „{s:arguments}”?\nJeśli nie chcesz uruchomić gry ten sposób, kliknij Anuluj."
"[english]Steam_AllowGameLaunch_Info"	"Allow {s:gamename} to launch with optional command line \"{s:arguments}\" ?\nIf you did not request this launch then click Cancel"
"Steam_AllowGameLaunch_Title"	"Zezwolenie na uruchomienie gry"
"[english]Steam_AllowGameLaunch_Title"	"Allow game launch"
"Panorama_Lang_Arabic"	"arabski"
"[english]Panorama_Lang_Arabic"	"Arabic"
"MainMenu_InboxShort"	"{d:inboxcount}"
"[english]MainMenu_InboxShort"	"{d:inboxcount}"
"MainMenu_InboxLong"	"{d:inboxcount}"
"[english]MainMenu_InboxLong"	"{d:inboxcount}"
"Checkout_PaymentMethod_MustSaveInfo"	"W koszyku znajduje się produkt wymagający odnawiania subskrypcji, w związku z tym twoje informacje o płatności zostaną zapisane."
"[english]Checkout_PaymentMethod_MustSaveInfo"	"Your payment information will be saved because your cart contains a renewing subscription"
"Library_Details_Controller_ButtonUnset"	"
"
"[english]Library_Details_Controller_ButtonUnset"	""
"Library_Details_ControllerCommunityBindingsInfo"	"Wygląda na to, że {s:gamename} nie posiada jeszcze udostępnionej konfiguracji klawiszy. Możesz stworzyć pierwszą!"
"[english]Library_Details_ControllerCommunityBindingsInfo"	"Looks like {s:gamename} doesn't yet have any shared bindings.  You could create the first!"
"Library_Controller_ControllerBindingSavedFailedPublish"	"Twoja konfiguracja klawiszy została zapisana, lecz publikacja jej w Warsztacie nie powiodła się."
"[english]Library_Controller_ControllerBindingSavedFailedPublish"	"Your bindings have been saved, but publishing to workshop has failed."
"Library_ControllerBindingsSteamDefaultTitle"	"Ustawienia domyślne Steam"
"[english]Library_ControllerBindingsSteamDefaultTitle"	"Steam Defaults"
"Library_UserTagsFilter"	"{s:tag} ({d:numgames})"
"[english]Library_UserTagsFilter"	"{s:tag} ({d:numgames})"
"Library_OwnerFilter"	"Gry użytkownika {s:owner} ({d:numgames})"
"[english]Library_OwnerFilter"	"{s:owner}'s Games ({d:numgames})"
}
